Date,Category,RefNo,Date,Withdrawal,Deposit,Balance
2023-01-01,Rent,3E+11,2023-01-01,3950,0,1837.23
2023-01-03,Misc,3E+11,2023-01-03,105,0,1732.23
2023-01-03,Misc,3.37E+11,2023-01-03,0,55,1787.23
2023-01-03,Food,3E+11,2023-01-03,56,0,1731.23
2023-01-03,Misc,3.37E+11,2023-01-03,1,0,1730.23
2023-01-03,Food,3E+11,2023-01-03,30,0,1700.23
2023-01-04,Misc,3E+11,2023-01-04,500,0,1200.23
2023-01-04,Misc,3E+11,2023-01-04,1,0,1199.23
2023-01-04,Misc,3E+11,2023-01-04,500,0,699.23
2023-01-10,Food,3.01E+11,2023-01-10,28,0,671.23
2023-01-10,Misc,3.01E+11,2023-01-10,149,0,522.23
2023-01-10,Food,3.01E+11,2023-01-10,10,0,512.23
2023-01-10,Misc,3.38E+11,2023-01-10,0,1289,1801.23
2023-01-10,Food,3.01E+11,2023-01-10,51,0,1750.23
2023-01-10,Misc,3.38E+11,2023-01-10,110,0,1640.23
2023-01-10,Food,3.38E+11,2023-01-10,40,0,1600.23
2023-01-10,Food,3.01E+11,2023-01-10,20,0,1580.23
2023-01-10,Food,3.38E+11,2023-01-10,131.5,0,1448.73
2023-01-10,Food,3.38E+11,2023-01-11,27,0,1421.73
2023-01-11,Food,3.01E+11,2023-01-11,50,0,1371.73
2023-01-11,Food,3.38E+11,2023-01-11,33,0,1338.73
2023-01-11,Misc,3.38E+11,2023-01-11,0,33,1371.73
2023-01-11,Food,3.01E+11,2023-01-11,33,0,1338.73
2023-01-11,Misc,3.01E+11,2023-01-11,0,33,1371.73
2023-01-11,Food,3.01E+11,2023-01-11,33,0,1338.73
2023-01-11,Food,3.38E+11,2023-01-11,60,0,1278.73
2023-01-11,Food,3.38E+11,2023-01-11,30,0,1248.73
2023-01-11,Misc,3.38E+11,2023-01-11,305,0,943.73
2023-01-11,Food,3.38E+11,2023-01-11,50,0,893.73
2023-01-11,Food,3.01E+11,2023-01-11,20,0,873.73
2023-01-12,Food,3.38E+11,2023-01-12,57,0,816.73
2023-01-12,Food,3.01E+11,2023-01-12,33,0,783.73
2023-01-12,Food,3.38E+11,2023-01-12,10,0,773.73
2023-01-12,Food,3.01E+11,2023-01-12,35,0,738.73
2023-01-12,Food,3.01E+11,2023-01-12,60,0,678.73
2023-01-12,Food,3.38E+11,2023-01-12,30,0,648.73
2023-01-12,Food,3.01E+11,2023-01-12,20,0,628.73
2023-01-13,Food,3.38E+11,2023-01-13,57,0,571.73
2023-01-13,Food,3.01E+11,2023-01-13,60,0,511.73
2023-01-13,Misc,3.38E+11,2023-01-13,480,0,31.73
2023-01-13,Food,3.38E+11,2023-01-13,12,0,19.73
2023-01-13,Misc,3.38E+11,2023-01-13,0,2000,2019.73
2023-01-13,Misc,3.38E+11,2023-01-13,0,120,2139.73
2023-01-13,Food,3.01E+11,2023-01-13,50,0,2089.73
2023-01-13,Misc,3.01E+11,2023-01-13,0,200,2289.73
2023-01-13,Food,3.38E+11,2023-01-13,15,0,2274.73
2023-01-14,Food,3.01E+11,2023-01-14,40,0,2234.73
2023-01-14,Food,3.38E+11,2023-01-14,30,0,2204.73
2023-01-14,Food,3.01E+11,2023-01-14,173.75,0,2030.98
2023-01-14,Misc,3.38E+11,2023-01-14,0,25,2055.98
2023-01-14,Food,3.38E+11,2023-01-14,50,0,2005.98
2023-01-14,Food,3.38E+11,2023-01-14,20,0,1985.98
2023-01-14,Misc,3.38E+11,2023-01-14,0,10,1995.98
2023-01-14,Food,3.38E+11,2023-01-14,30,0,1965.98
2023-01-15,Misc,3.38E+11,2023-01-15,110,0,1855.98
2023-01-15,Food,3.02E+11,2023-01-15,35,0,1820.98
2023-01-15,Misc,3.38E+11,2023-01-15,200,0,1620.98
2023-01-15,Food,3.38E+11,2023-01-15,30,0,1590.98
2023-01-15,Food,3.38E+11,2023-01-15,40,0,1550.98
2023-01-15,Food,3.38E+11,2023-01-15,155.24,0,1395.74
2023-01-15,Food,3.38E+11,2023-01-15,25,0,1370.74
2023-01-16,Food,3.02E+11,2023-01-16,12,0,1358.74
2023-01-16,Food,3.02E+11,2023-01-16,33,0,1325.74
2023-01-16,Food,3.38E+11,2023-01-16,29,0,1296.74
2023-01-16,Food,3.38E+11,2023-01-16,50,0,1246.74
2023-01-16,Food,3.38E+11,2023-01-16,60,0,1186.74
2023-01-16,Food,3.38E+11,2023-01-16,32,0,1154.74
2023-01-16,Food,3.38E+11,2023-01-16,20,0,1134.74
2023-01-17,Food,3.02E+11,2023-01-17,37,0,1097.74
2023-01-17,Misc,3.02E+11,2023-01-17,272,0,825.74
2023-01-17,Food,3.38E+11,2023-01-17,70,0,755.74
2023-01-17,Food,3.38E+11,2023-01-17,30,0,725.74
2023-01-17,Food,3.02E+11,2023-01-17,85,0,640.74
2023-01-17,Food,3.38E+11,2023-01-17,20,0,620.74
2023-01-17,Food,3.38E+11,2023-01-17,20,0,600.74
2023-01-18,Food,3.38E+11,2023-01-18,10,0,590.74
2023-01-18,Food,3.02E+11,2023-01-18,33,0,557.74
2023-01-18,Food,3.38E+11,2023-01-18,20,0,537.74
2023-01-18,Food,3.38E+11,2023-01-18,60,0,477.74
2023-01-18,Food,3.38E+11,2023-01-18,40,0,437.74
2023-01-18,Food,3.38E+11,2023-01-18,40,0,397.74
2023-01-19,Misc,3.02E+11,2023-01-19,0,120,517.74
2023-01-19,Misc,3.39E+11,2023-01-19,130,0,387.74
2023-01-19,Food,3.39E+11,2023-01-19,30,0,357.74
2023-01-19,Food,3.39E+11,2023-01-19,12,0,345.74
2023-01-19,Food,3.02E+11,2023-01-19,25,0,320.74
2023-01-19,Food,3.02E+11,2023-01-19,55,0,265.74
2023-01-20,Food,3.39E+11,2023-01-20,10,0,255.74
2023-01-20,Food,3.39E+11,2023-01-20,42,0,213.74
2023-01-20,Food,3.39E+11,2023-01-20,30,0,183.74
2023-01-20,Food,3.02E+11,2023-01-20,20,0,163.74
2023-01-20,Food,3.39E+11,2023-01-20,40,0,123.74
2023-01-20,Misc,3.39E+11,2023-01-21,0,500,623.74
2023-01-21,Food,3.02E+11,2023-01-21,42,0,581.74
2023-01-21,Food,3.02E+11,2023-01-21,80,0,501.74
2023-01-21,Food,3.02E+11,2023-01-21,30,0,471.74
2023-01-21,Food,3.39E+11,2023-01-21,25,0,446.74
2023-01-21,Misc,3.39E+11,2023-01-21,200,0,246.74
2023-01-21,Food,3.02E+11,2023-01-21,30,0,216.74
2023-01-21,Misc,3.39E+11,2023-01-21,200,0,16.74
2023-01-22,Misc,3.02E+11,2023-01-22,0,2000,2016.74
2023-01-22,Food,3.39E+11,2023-01-22,61,0,1955.74
2023-01-22,Misc,3.39E+11,2023-01-22,115,0,1840.74
2023-01-22,Food,3.39E+11,2023-01-22,30,0,1810.74
2023-01-23,Food,3.02E+11,2023-01-23,15,0,1795.74
2023-01-23,Food,3.02E+11,2023-01-23,33,0,1762.74
2023-01-23,Food,3.39E+11,2023-01-23,65,0,1697.74
2023-01-23,Food,3.39E+11,2023-01-23,30,0,1667.74
2023-01-23,Food,3.02E+11,2023-01-23,70,0,1597.74
2023-01-23,Misc,3.39E+11,2023-01-23,0,35,1632.74
2023-01-23,Food,3.39E+11,2023-01-23,30,0,1602.74
2023-01-24,Food,3.39E+11,2023-01-24,20,0,1582.74
2023-01-24,Food,3.39E+11,2023-01-24,90,0,1492.74
2023-01-24,Food,3.02E+11,2023-01-24,75,0,1417.74
2023-01-24,Food,3.02E+11,2023-01-24,20,0,1397.74
2023-01-24,Food,3.39E+11,2023-01-24,50,0,1347.74
2023-01-25,Food,3.03E+11,2023-01-25,28,0,1319.74
2023-01-25,Salary,CHASR23023738798,2023-01-25,0,34800,36119.74
2023-01-25,Food,3.39E+11,2023-01-25,65,0,36054.74
2023-01-25,Food,3.03E+11,2023-01-25,27,0,36027.74
2023-01-25,Food,3.03E+11,2023-01-25,30,0,35997.74
2023-01-25,Misc,3.39E+11,2023-01-25,10000,0,25997.74
2023-01-25,Misc,3.39E+11,2023-01-25,350,0,25647.74
2023-01-25,Food,3.39E+11,2023-01-25,40,0,25607.74
2023-01-25,Misc,3.39E+11,2023-01-25,2,0,25605.74
2023-01-25,Misc,3.39E+11,2023-01-25,135,0,25470.74
2023-01-26,Food,3.03E+11,2023-01-26,20,0,25450.74
2023-01-26,Misc,3.03E+11,2023-01-26,120,0,25330.74
2023-01-26,Shopping,3.03E+11,2023-01-26,1081,0,24249.74
2023-01-26,Misc,3.03E+11,2023-01-26,5000,0,19249.74
2023-01-26,Misc,3.39E+11,2023-01-26,299,0,18950.74
2023-01-26,Misc,3.39E+11,2023-01-26,2000,0,16950.74
2023-01-26,Misc,3.03E+11,2023-01-26,1000,0,15950.74
2023-01-26,Misc,3.39E+11,2023-01-26,0,5000,20950.74
2023-01-26,Misc,3.39E+11,2023-01-26,5000,0,15950.74
2023-01-26,Food,3.39E+11,2023-01-26,163.28,0,15787.46
2023-01-27,Food,3.03E+11,2023-01-27,24,0,15763.46
2023-01-27,Misc,3.39E+11,2023-01-27,288,0,15475.46
2023-01-27,Food,3.39E+11,2023-01-27,70,0,15405.46
2023-01-27,Misc,3.39E+11,2023-01-27,0,72,15477.46
2023-01-27,Misc,3.03E+11,2023-01-27,0,7000,22477.46
2023-01-27,Misc,3.03E+11,2023-01-27,17500,0,4977.46
2023-01-27,Food,3.39E+11,2023-01-27,40,0,4937.46
2023-01-27,Food,3.39E+11,2023-01-27,80,0,4857.46
2023-01-28,Food,3.39E+11,2023-01-28,40,0,4817.46
2023-01-28,Food,3.03E+11,2023-01-28,40,0,4777.46
2023-01-28,Misc,3.03E+11,2023-01-28,1000,0,3777.46
2023-01-28,Food,3.39E+11,2023-01-28,40,0,3737.46
2023-01-29,Food,3.4E+11,2023-01-29,20,0,3717.46
2023-01-29,Food,3.03E+11,2023-01-29,40,0,3677.46
2023-01-29,Misc,3.4E+11,2023-01-29,149,0,3528.46
2023-01-29,Misc,3.03E+11,2023-01-29,250,0,3278.46
2023-01-29,Misc,3.4E+11,2023-01-29,250,0,3028.46
2023-01-29,Misc,3.4E+11,2023-01-29,500,0,2528.46
2023-01-29,Food,3.4E+11,2023-01-29,189.05,0,2339.41
2023-01-29,Food,3.4E+11,2023-01-30,40,0,2299.41
2023-01-30,Food,3.03E+11,2023-01-30,50,0,2249.41
2023-01-30,Food,3.4E+11,2023-01-30,85,0,2164.41
2023-01-30,Food,3.4E+11,2023-01-30,50,0,2114.41
2023-01-30,Food,3.4E+11,2023-01-30,90,0,2024.41
2023-01-30,Food,3.4E+11,2023-01-30,20,0,2004.41
2023-01-31,Food,3.03E+11,2023-01-31,28,0,1976.41
2023-01-31,Misc,3.4E+11,2023-01-31,125,0,1851.41
2023-01-31,Food,3.03E+11,2023-01-31,40,0,1811.41
2023-01-31,Misc,3.03E+11,2023-01-31,0,10000,11811.41
2023-01-31,Food,3.4E+11,2023-01-31,154.44,0,11656.97
2023-02-01,Food,3.03E+11,2023-02-01,30,0,11626.97
2023-02-01,Food,3.4E+11,2023-02-01,20,0,11606.97
2023-02-01,Food,3.03E+11,2023-02-01,80,0,11526.97
2023-02-02,Rent,3.03E+11,2023-02-02,5776,0,5750.97
2023-02-02,Food,3.4E+11,2023-02-02,20,0,5730.97
2023-02-02,Food,3.03E+11,2023-02-02,144.87,0,5586.1
2023-02-02,Food,3.4E+11,2023-02-02,40,0,5546.1
2023-02-02,Food,3.4E+11,2023-02-02,30,0,5516.1
2023-02-02,Misc,3.4E+11,2023-02-02,170,0,5346.1
2023-02-03,Food,3.03E+11,2023-02-03,28,0,5318.1
2023-02-03,Food,3.4E+11,2023-02-03,50,0,5268.1
2023-02-03,Misc,3.03E+11,2023-02-03,500,0,4768.1
2023-02-03,Misc,3.03E+11,2023-02-03,0,500,5268.1
2023-02-03,Food,3.4E+11,2023-02-03,17,0,5251.1
2023-02-03,Misc,3.4E+11,2023-02-03,190,0,5061.1
2023-02-03,Food,3.4E+11,2023-02-03,40,0,5021.1
2023-02-04,Misc,3.04E+11,2023-02-04,200,0,4821.1
2023-02-04,Food,3.4E+11,2023-02-04,30,0,4791.1
2023-02-04,Food,3.04E+11,2023-02-04,40,0,4751.1
2023-02-04,Misc,3.4E+11,2023-02-04,0,152,4903.1
2023-02-04,Misc,3.4E+11,2023-02-04,140,0,4763.1
2023-02-04,Food,3.4E+11,2023-02-04,30,0,4733.1
2023-02-04,Food,3.4E+11,2023-02-04,40,0,4693.1
2023-02-05,Food,3.4E+11,2023-02-05,40,0,4653.1
2023-02-05,Misc,3.4E+11,2023-02-05,180,0,4473.1
2023-02-06,Food,3.4E+11,2023-02-06,80,0,4393.1
2023-02-06,Food,3.4E+11,2023-02-06,100,0,4293.1
2023-02-06,Food,3.04E+11,2023-02-06,20,0,4273.1
2023-02-06,Misc,3.04E+11,2023-02-06,700,0,3573.1
2023-02-06,Food,3.4E+11,2023-02-06,20,0,3553.1
2023-02-07,Food,3.4E+11,2023-02-07,65,0,3488.1
2023-02-07,Food,3.04E+11,2023-02-07,36,0,3452.1
2023-02-07,Food,3.4E+11,2023-02-07,40,0,3412.1
2023-02-07,Food,3.4E+11,2023-02-07,10,0,3402.1
2023-02-08,Food,3.41E+11,2023-02-08,150.28,0,3251.82
2023-02-08,Food,3.04E+11,2023-02-08,20,0,3231.82
2023-02-08,Misc,3.04E+11,2023-02-08,500,0,2731.82
2023-02-08,Food,3.41E+11,2023-02-08,30,0,2701.82
2023-02-09,Food,3.04E+11,2023-02-09,33,0,2668.82
2023-02-09,Food,3.41E+11,2023-02-09,30,0,2638.82
2023-02-09,Shopping,3.04E+11,2023-02-09,474,0,2164.82
2023-02-09,Food,3.41E+11,2023-02-09,32,0,2132.82
2023-02-09,Food,3.41E+11,2023-02-09,20,0,2112.82
2023-02-10,Food,3.04E+11,2023-02-10,40,0,2072.82
2023-02-10,Food,3.41E+11,2023-02-10,54,0,2018.82
2023-02-10,Food,3.41E+11,2023-02-10,51,0,1967.82
2023-02-10,Food,3.04E+11,2023-02-10,60,0,1907.82
2023-02-10,Food,3.04E+11,2023-02-10,39,0,1868.82
2023-02-10,Food,3.41E+11,2023-02-10,30,0,1838.82
2023-02-10,Food,3.41E+11,2023-02-10,52,0,1786.82
2023-02-11,Shopping,3.04E+11,2023-02-11,0,249,2035.82
2023-02-11,Shopping,3.04E+11,2023-02-11,0,225,2260.82
2023-02-11,Shopping,3.04E+11,2023-02-11,261,0,1999.82
2023-02-11,Food,3.04E+11,2023-02-11,32,0,1967.82
2023-02-11,Food,3.04E+11,2023-02-11,150.28,0,1817.54
2023-02-11,Food,3.41E+11,2023-02-11,60,0,1757.54
2023-02-11,Misc,3.04E+11,2023-02-11,0,500,2257.54
2023-02-12,Misc,3.41E+11,2023-02-12,330,0,1927.54
2023-02-12,Food,3.41E+11,2023-02-12,44,0,1883.54
2023-02-12,Food,3.41E+11,2023-02-12,100,0,1783.54
2023-02-12,Misc,3.04E+11,2023-02-12,500,0,1283.54
2023-02-12,Misc,3.04E+11,2023-02-12,117,0,1166.54
2023-02-12,Food,3.04E+11,2023-02-12,25,0,1141.54
2023-02-12,Food,3.04E+11,2023-02-12,30,0,1111.54
2023-02-13,Food,3.04E+11,2023-02-13,40,0,1071.54
2023-02-13,Food,3.41E+11,2023-02-13,173.7,0,897.84
2023-02-13,Food,3.04E+11,2023-02-13,67,0,830.84
2023-02-13,Food,3.41E+11,2023-02-13,40,0,790.84
2023-02-14,Food,3.41E+11,2023-02-14,40,0,750.84
2023-02-14,Food,3.05E+11,2023-02-14,242.45,0,508.39
2023-02-14,Food,3.05E+11,2023-02-14,60,0,448.39
2023-02-15,Food,3.05E+11,2023-02-15,40,0,408.39
2023-02-15,Food,3.05E+11,2023-02-15,148,0,260.39
2023-02-15,Misc,3.05E+11,2023-02-15,130,0,130.39
2023-02-16,Food,3.05E+11,2023-02-16,30,0,100.39
2023-02-16,Food,3.41E+11,2023-02-16,40,0,60.39
2023-02-16,Misc,3.05E+11,2023-02-16,0,80,140.39
2023-02-16,Food,3.05E+11,2023-02-16,100,0,40.39
2023-02-16,Misc,3.41E+11,2023-02-16,0,1500,1540.39
2023-02-17,Misc,3.05E+11,2023-02-17,5,0,1535.39
2023-02-17,Food,3.41E+11,2023-02-17,20,0,1515.39
2023-02-17,Food,3.05E+11,2023-02-17,30,0,1485.39
2023-02-17,Food,3.41E+11,2023-02-17,65,0,1420.39
2023-02-17,Food,3.41E+11,2023-02-17,30,0,1390.39
2023-02-17,Food,3.41E+11,2023-02-17,70,0,1320.39
2023-02-17,Food,3.05E+11,2023-02-17,50,0,1270.39
2023-02-17,Misc,3.05E+11,2023-02-17,475,0,795.39
2023-02-17,Food,3.41E+11,2023-02-17,30,0,765.39
2023-02-18,Food,3.42E+11,2023-02-18,10,0,755.39
2023-02-18,Food,3.05E+11,2023-02-18,60,0,695.39
2023-02-18,Food,3.42E+11,2023-02-18,20,0,675.39
2023-02-18,Food,3.42E+11,2023-02-18,70,0,605.39
2023-02-18,Food,3.42E+11,2023-02-18,20,0,585.39
2023-02-19,Misc,3.05E+11,2023-02-19,150.5,0,434.89
2023-02-19,Misc,3.05E+11,2023-02-19,136,0,298.89
2023-02-19,Misc,3.42E+11,2023-02-19,8,0,290.89
2023-02-19,Food,3.05E+11,2023-02-19,67,0,223.89
2023-02-19,Food,3.05E+11,2023-02-19,100,0,123.89
2023-02-19,Food,3.42E+11,2023-02-19,40,0,83.89
2023-02-20,Food,3.42E+11,2023-02-20,40,0,43.89
2023-02-20,Misc,3.42E+11,2023-02-20,0,500,543.89
2023-02-20,Food,3.05E+11,2023-02-20,65,0,478.89
2023-02-20,Food,3.42E+11,2023-02-20,20,0,458.89
2023-02-20,Food,3.05E+11,2023-02-20,45,0,413.89
2023-02-21,Food,3.42E+11,2023-02-21,33,0,380.89
2023-02-21,Food,3.05E+11,2023-02-21,40,0,340.89
2023-02-21,Food,3.42E+11,2023-02-21,30,0,310.89
2023-02-21,Food,3.05E+11,2023-02-21,50,0,260.89
2023-02-21,Food,3.05E+11,2023-02-21,35,0,225.89
2023-02-22,Misc,3.42E+11,2023-02-22,0,6000,6225.89
2023-02-22,Misc,3.05E+11,2023-02-22,5500,0,725.89
2023-02-22,Food,3.42E+11,2023-02-22,50,0,675.89
2023-02-22,Food,3.42E+11,2023-02-22,35,0,640.89
2023-02-22,Food,3.05E+11,2023-02-22,50,0,590.89
2023-02-22,Food,3.05E+11,2023-02-22,42,0,548.89
2023-02-23,Food,3.42E+11,2023-02-23,20,0,528.89
2023-02-23,Food,3.05E+11,2023-02-23,40,0,488.89
2023-02-23,Misc,3.42E+11,2023-02-23,400,0,88.89
2023-02-23,Food,3.05E+11,2023-02-23,30,0,58.89
2023-02-23,Food,3.05E+11,2023-02-23,40,0,18.89
2023-02-24,Salary,CHASS23053481613,2023-02-24,0,34800,34818.89
2023-02-24,Food,3.06E+11,2023-02-24,70,0,34748.89
2023-02-24,Food,3.06E+11,2023-02-24,40,0,34708.89
2023-02-24,Misc,3.06E+11,2023-02-24,799,0,33909.89
2023-02-24,Misc,3.42E+11,2023-02-24,180,0,33729.89
2023-02-24,Food,3.42E+11,2023-02-24,75,0,33654.89
2023-02-24,Misc,3.06E+11,2023-02-24,642,0,33012.89
2023-02-24,Food,3.42E+11,2023-02-24,12,0,33000.89
2023-02-25,Misc,3.42E+11,2023-02-25,10000,0,23000.89
2023-02-25,Misc,3.06E+11,2023-02-25,140,0,22860.89
2023-02-25,Food,3.42E+11,2023-02-25,20,0,22840.89
2023-02-25,Food,3.42E+11,2023-02-25,10,0,22830.89
2023-02-25,Food,3.42E+11,2023-02-25,40,0,22790.89
2023-02-25,Misc,3.42E+11,2023-02-25,500,0,22290.89
2023-02-25,Food,3.42E+11,2023-02-25,25,0,22265.89
2023-02-25,Misc,3.42E+11,2023-02-25,0,2000,24265.89
2023-02-25,Misc,3.42E+11,2023-02-25,4003,0,20262.89
2023-02-26,Food,3.06E+11,2023-02-26,34,0,20228.89
2023-02-26,Food,3.06E+11,2023-02-26,22,0,20206.89
2023-02-26,Food,3.06E+11,2023-02-26,10,0,20196.89
2023-02-26,Misc,3.06E+11,2023-02-26,0,3400,23596.89
2023-02-26,Food,3.42E+11,2023-02-26,20,0,23576.89
2023-02-26,Misc,3.06E+11,2023-02-26,4000,0,19576.89
2023-02-26,Shopping,3.06E+11,2023-02-26,251,0,19325.89
2023-02-26,Misc,3.42E+11,2023-02-26,1000,0,18325.89
2023-02-26,Shopping,3.42E+11,2023-02-26,429,0,17896.89
2023-02-26,Misc,3.06E+11,2023-02-26,2000,0,15896.89
2023-02-26,Misc,3.06E+11,2023-02-26,302,0,15594.89
2023-02-27,Shopping,3.06E+11,2023-02-27,299,0,15295.89
2023-02-27,Food,3.06E+11,2023-02-27,20,0,15275.89
2023-02-27,Food,3.42E+11,2023-02-27,40,0,15235.89
2023-02-27,Misc,3.06E+11,2023-02-27,570,0,14665.89
2023-02-27,Misc,3.06E+11,2023-02-27,306,0,14359.89
2023-02-27,Food,3.06E+11,2023-02-27,100,0,14259.89
2023-02-27,Misc,3.06E+11,2023-02-27,1315,0,12944.89
2023-02-27,Food,3.42E+11,2023-02-27,25,0,12919.89
2023-02-27,Food,3.42E+11,2023-02-27,20,0,12899.89
2023-02-28,Food,3.06E+11,2023-02-28,68,0,12831.89
2023-02-28,Food,3.43E+11,2023-02-28,65,0,12766.89
2023-02-28,Food,3.43E+11,2023-02-28,40,0,12726.89
2023-02-28,Misc,3.06E+11,2023-02-28,830,0,11896.89
2023-03-01,Food,3.43E+11,2023-03-01,60,0,11836.89
2023-03-01,Food,3.43E+11,2023-03-01,30,0,11806.89
2023-03-02,Food,3.43E+11,2023-03-02,28,0,11778.89
2023-03-02,Misc,3.43E+11,2023-03-02,110,0,11668.89
2023-03-02,Food,3.43E+11,2023-03-02,50,0,11618.89
2023-03-02,Misc,3.43E+11,2023-03-02,500,0,11118.89
2023-03-02,Food,3.43E+11,2023-03-02,30,0,11088.89
2023-03-03,Food,3.43E+11,2023-03-03,33,0,11055.89
2023-03-03,Misc,3.43E+11,2023-03-03,240,0,10815.89
2023-03-03,Food,3.43E+11,2023-03-03,60,0,10755.89
2023-03-03,Rent,3.06E+11,2023-03-03,6490,0,4265.89
2023-03-03,Food,3.06E+11,2023-03-03,35,0,4230.89
2023-03-04,Misc,3.06E+11,2023-03-04,105,0,4125.89
2023-03-04,Food,3.06E+11,2023-03-04,10,0,4115.89
2023-03-04,Food,3.43E+11,2023-03-04,30,0,4085.89
2023-03-04,Food,3.43E+11,2023-03-04,25,0,4060.89
2023-03-04,Misc,3.06E+11,2023-03-04,200,0,3860.89
2023-03-04,Misc,3.43E+11,2023-03-04,420,0,3440.89
2023-03-04,Food,3.43E+11,2023-03-04,40,0,3400.89
2023-03-05,Food,3.06E+11,2023-03-05,30,0,3370.89
2023-03-05,Food,3.43E+11,2023-03-05,100,0,3270.89
2023-03-05,Misc,3.06E+11,2023-03-05,300,0,2970.89
2023-03-05,Food,3.06E+11,2023-03-05,40,0,2930.89
2023-03-05,Misc,3.06E+11,2023-03-05,500,0,2430.89
2023-03-05,Food,3.06E+11,2023-03-05,20,0,2410.89
2023-03-06,Misc,3.43E+11,2023-03-06,0,131,2541.89
2023-03-06,Food,3.43E+11,2023-03-06,50,0,2491.89
2023-03-06,Food,3.07E+11,2023-03-06,37,0,2454.89
2023-03-06,Food,3.43E+11,2023-03-06,40,0,2414.89
2023-03-07,Food,3.43E+11,2023-03-07,72,0,2342.89
2023-03-07,Food,3.43E+11,2023-03-07,50,0,2292.89
2023-03-07,Food,3.07E+11,2023-03-07,25,0,2267.89
2023-03-07,Food,3.43E+11,2023-03-07,35,0,2232.89
2023-03-08,Misc,3.07E+11,2023-03-08,7,0,2225.89
2023-03-08,Food,3.07E+11,2023-03-08,30,0,2195.89
2023-03-08,Food,3.07E+11,2023-03-08,75,0,2120.89
2023-03-08,Misc,3.07E+11,2023-03-08,150.5,0,1970.39
2023-03-08,Food,3.07E+11,2023-03-08,40,0,1930.39
2023-03-09,Food,3.07E+11,2023-03-09,99,0,1831.39
2023-03-09,Food,3.07E+11,2023-03-09,34,0,1797.39
2023-03-09,Misc,3.43E+11,2023-03-09,205,0,1592.39
2023-03-09,Food,3.43E+11,2023-03-09,60,0,1532.39
2023-03-09,Food,3.07E+11,2023-03-09,79,0,1453.39
2023-03-09,Food,3.43E+11,2023-03-09,160.87,0,1292.52
2023-03-10,Food,3.07E+11,2023-03-10,50,0,1242.52
2023-03-10,Food,3.44E+11,2023-03-10,50,0,1192.52
2023-03-10,Food,3.07E+11,2023-03-10,214.96,0,977.56
2023-03-10,Misc,3.07E+11,2023-03-10,0,300,1277.56
2023-03-10,Food,3.07E+11,2023-03-10,70,0,1207.56
2023-03-11,Food,3.07E+11,2023-03-11,62,0,1145.56
2023-03-11,Misc,3.44E+11,2023-03-11,0,210,1355.56
2023-03-11,Misc,3.07E+11,2023-03-11,500,0,855.56
2023-03-11,Food,3.44E+11,2023-03-11,60,0,795.56
2023-03-11,Food,3.44E+11,2023-03-11,25.3,0,770.26
2023-03-12,Misc,3.07E+11,2023-03-12,300,0,470.26
2023-03-12,Food,3.07E+11,2023-03-12,30,0,440.26
2023-03-12,Food,3.07E+11,2023-03-12,40,0,400.26
2023-03-12,Food,3.44E+11,2023-03-12,54,0,346.26
2023-03-12,Food,3.44E+11,2023-03-12,40,0,306.26
2023-03-13,Food,3.07E+11,2023-03-13,20,0,286.26
2023-03-13,Food,3.07E+11,2023-03-13,47,0,239.26
2023-03-13,Food,3.44E+11,2023-03-13,65,0,174.26
2023-03-13,Food,3.07E+11,2023-03-13,50,0,124.26
2023-03-13,Food,3.07E+11,2023-03-13,85,0,39.26
2023-03-14,Misc,3.07E+11,2023-03-14,0,1000,1039.26
2023-03-14,Food,3.44E+11,2023-03-14,79,0,960.26
2023-03-14,Food,3.07E+11,2023-03-14,30,0,930.26
2023-03-14,Food,3.07E+11,2023-03-14,55,0,875.26
2023-03-15,Food,3.44E+11,2023-03-15,33,0,842.26
2023-03-15,Food,3.44E+11,2023-03-15,50,0,792.26
2023-03-15,Food,3.07E+11,2023-03-16,55,0,737.26
2023-03-16,Misc,3.08E+11,2023-03-16,136,0,601.26
2023-03-16,Food,3.44E+11,2023-03-16,50,0,551.26
2023-03-16,Food,3.44E+11,2023-03-16,35,0,516.26
2023-03-16,Food,3.08E+11,2023-03-16,30,0,486.26
2023-03-16,Food,3.08E+11,2023-03-16,65,0,421.26
2023-03-17,Food,3.08E+11,2023-03-17,50,0,371.26
2023-03-17,Food,3.08E+11,2023-03-17,30,0,341.26
2023-03-17,Food,3.08E+11,2023-03-17,30,0,311.26
2023-03-17,Food,3.08E+11,2023-03-17,75,0,236.26
2023-03-18,Food,3.44E+11,2023-03-18,30,0,206.26
2023-03-18,Food,3.08E+11,2023-03-18,35,0,171.26
2023-03-18,Food,3.08E+11,2023-03-18,30,0,141.26
2023-03-19,Food,3.44E+11,2023-03-19,61,0,80.26
2023-03-19,Food,3.08E+11,2023-03-19,30,0,50.26
2023-03-19,Food,3.08E+11,2023-03-19,10,0,40.26
2023-03-20,Food,3.08E+11,2023-03-20,30,0,10.26
2023-03-21,Misc,3.08E+11,2023-03-21,0,60,70.26
2023-03-21,Misc,3.45E+11,2023-03-21,0,40,110.26
2023-03-22,Misc,3.45E+11,2023-03-22,2,0,108.26
2023-03-22,Food,3.45E+11,2023-03-22,42,0,66.26
2023-03-24,Salary,CHAST23081324539,2023-03-24,0,34800,34866.26
2023-03-24,Misc,3.45E+11,2023-03-24,11000,0,23866.26
2023-03-24,Misc,3.45E+11,2023-03-24,1926.72,0,21939.54
2023-03-24,Shopping,3.08E+11,2023-03-24,670,0,21269.54
2023-03-24,Misc,3.45E+11,2023-03-24,1479,0,19790.54
2023-03-24,Food,3.08E+11,2023-03-24,81,0,19709.54
2023-03-24,Food,3.45E+11,2023-03-24,48,0,19661.54
2023-03-24,Food,3.45E+11,2023-03-24,72,0,19589.54
2023-03-24,Food,3.08E+11,2023-03-24,42,0,19547.54
2023-03-24,Misc,3.08E+11,2023-03-24,5000,0,14547.54
2023-03-24,Misc,3.08E+11,2023-03-24,660,0,13887.54
2023-03-24,Food,3.45E+11,2023-03-24,66,0,13821.54
2023-03-24,Food,3.45E+11,2023-03-24,30,0,13791.54
2023-03-24,Food,3.45E+11,2023-03-24,100,0,13691.54
2023-03-24,Misc,3.08E+11,2023-03-24,1500,0,12191.54
2023-03-24,Food,3.08E+11,2023-03-24,10,0,12181.54
2023-03-25,Food,3.08E+11,2023-03-25,76,0,12105.54
2023-03-25,Food,3.45E+11,2023-03-25,22,0,12083.54
2023-03-25,Food,3.45E+11,2023-03-25,87,0,11996.54
2023-03-25,Misc,3.08E+11,2023-03-25,470,0,11526.54
2023-03-25,Misc,3.08E+11,2023-03-26,2826,0,8700.54
2023-03-26,Food,3.09E+11,2023-03-26,32,0,8668.54
2023-03-26,Food,3.09E+11,2023-03-26,72,0,8596.54
2023-03-26,Food,3.45E+11,2023-03-26,10,0,8586.54
2023-03-26,Misc,3.45E+11,2023-03-26,0,421,9007.54
2023-03-26,Misc,3.09E+11,2023-03-26,150,0,8857.54
2023-03-26,Food,3.09E+11,2023-03-26,80,0,8777.54
2023-03-26,Food,3.45E+11,2023-03-26,41,0,8736.54
2023-03-26,Misc,3.45E+11,2023-03-26,0,1000,9736.54
2023-03-26,Misc,3.09E+11,2023-03-26,0,802,10538.54
2023-03-26,Misc,3.09E+11,2023-03-26,0,927,11465.54
2023-03-26,Food,3.09E+11,2023-03-26,10,0,11455.54
2023-03-27,Shopping,3.45E+11,2023-03-27,254,0,11201.54
2023-03-27,Misc,3.45E+11,2023-03-27,0,5130,16331.54
2023-03-27,Food,3.45E+11,2023-03-27,40,0,16291.54
2023-03-28,Misc,3.45E+11,2023-03-28,210.9,0,16080.64
2023-03-28,Misc,3.45E+11,2023-03-28,144,0,15936.64
2023-03-28,Misc,3.09E+11,2023-03-28,1000,0,14936.64
2023-03-28,Food,3.45E+11,2023-03-28,52,0,14884.64
2023-03-28,Food,3.45E+11,2023-03-28,30,0,14854.64
2023-03-28,Food,3.45E+11,2023-03-28,42,0,14812.64
2023-03-29,Food,3.45E+11,2023-03-29,22,0,14790.64
2023-03-29,Food,3.45E+11,2023-03-29,32,0,14758.64
2023-03-29,Misc,3.45E+11,2023-03-29,353,0,14405.64
2023-03-29,Food,3.45E+11,2023-03-29,42,0,14363.64
2023-03-29,Food,3.09E+11,2023-03-29,15.35,0,14348.29
2023-03-29,Misc,3.09E+11,2023-03-29,220,0,14128.29
2023-03-29,Food,3.45E+11,2023-03-29,20,0,14108.29
2023-03-30,Food,3.46E+11,2023-03-30,90,0,14018.29
2023-03-30,Misc,3.46E+11,2023-03-30,150,0,13868.29
2023-03-30,Food,3.46E+11,2023-03-30,42,0,13826.29
2023-03-30,Food,3.46E+11,2023-03-30,15.35,0,13810.94
2023-03-30,Misc,3.46E+11,2023-03-30,354,0,13456.94
2023-03-30,Food,3.46E+11,2023-03-30,55,0,13401.94
2023-03-30,Food,3.09E+11,2023-03-30,75,0,13326.94
2023-03-30,Food,3.09E+11,2023-03-30,50,0,13276.94
2023-03-31,Food,3.46E+11,2023-03-31,47,0,13229.94
2023-03-31,Food,3.46E+11,2023-03-31,40,0,13189.94
2023-03-31,Misc,3.46E+11,2023-03-31,115,0,13074.94
2023-03-31,Food,3.46E+11,2023-03-31,22,0,13052.94
2023-04-01,Rent,3.09E+11,2023-04-01,6356,0,6696.94
2023-04-01,Misc,0,2023-03-31,0,32,6728.94
2023-04-01,Food,3.09E+11,2023-04-01,42,0,6686.94
2023-04-01,Food,3.09E+11,2023-04-01,267.15,0,6419.79
2023-04-01,Misc,3.09E+11,2023-04-01,550,0,5869.79
2023-04-01,Food,3.46E+11,2023-04-01,42,0,5827.79
2023-04-02,Food,3.46E+11,2023-04-02,32,0,5795.79
2023-04-02,Misc,3.09E+11,2023-04-02,150,0,5645.79
2023-04-02,Misc,3.46E+11,2023-04-02,1200,0,4445.79
2023-04-03,Misc,3.46E+11,2023-04-03,0,1200,5645.79
2023-04-03,Food,3.46E+11,2023-04-03,82,0,5563.79
2023-04-03,Food,3.09E+11,2023-04-03,85,0,5478.79
2023-04-03,Misc,3.09E+11,2023-04-03,295,0,5183.79
2023-04-03,Food,3.09E+11,2023-04-03,20,0,5163.79
2023-04-03,Food,3.46E+11,2023-04-03,10,0,5153.79
2023-04-04,Misc,3.46E+11,2023-04-04,150,0,5003.79
2023-04-04,Food,3.46E+11,2023-04-04,52,0,4951.79
2023-04-04,Misc,3.09E+11,2023-04-04,1000,0,3951.79
2023-04-04,Misc,3.46E+11,2023-04-04,144,0,3807.79
2023-04-04,Food,3.09E+11,2023-04-04,65,0,3742.79
2023-04-04,Shopping,3.46E+11,2023-04-04,54,0,3688.79
2023-04-05,Shopping,3.1E+11,2023-04-05,0,54,3742.79
2023-04-05,Misc,3.1E+11,2023-04-05,2000,0,1742.79
2023-04-05,Food,3.1E+11,2023-04-05,42,0,1700.79
2023-04-05,Misc,3.1E+11,2023-04-05,300,0,1400.79
2023-04-05,Food,3.1E+11,2023-04-05,90,0,1310.79
2023-04-06,Food,3.1E+11,2023-04-06,30,0,1280.79
2023-04-06,Food,3.1E+11,2023-04-06,20,0,1260.79
2023-04-06,Misc,3.46E+11,2023-04-06,250,0,1010.79
2023-04-06,Misc,3.1E+11,2023-04-06,120,0,890.79
2023-04-06,Food,3.1E+11,2023-04-06,20,0,870.79
2023-04-07,Food,3.1E+11,2023-04-07,55,0,815.79
2023-04-07,Food,3.1E+11,2023-04-07,10,0,805.79
2023-04-07,Food,3.1E+11,2023-04-07,50,0,755.79
2023-04-07,Food,3.46E+11,2023-04-07,32,0,723.79
2023-04-07,Food,3.1E+11,2023-04-07,65,0,658.79
2023-04-07,Food,3.1E+11,2023-04-07,20,0,638.79
2023-04-07,Misc,3.46E+11,2023-04-07,220,0,418.79
2023-04-07,Food,3.46E+11,2023-04-07,51,0,367.79
2023-04-08,Food,3.46E+11,2023-04-08,50,0,317.79
2023-04-08,Misc,3.1E+11,2023-04-08,0,1000,1317.79
2023-04-08,Food,3.46E+11,2023-04-08,70,0,1247.79
2023-04-08,Food,3.1E+11,2023-04-08,208.28,0,1039.51
2023-04-09,Misc,3.47E+11,2023-04-09,310,0,729.51
2023-04-09,Food,3.47E+11,2023-04-09,76,0,653.51
2023-04-09,Food,3.47E+11,2023-04-09,100,0,553.51
2023-04-09,Food,3.47E+11,2023-04-09,20,0,533.51
2023-04-10,Misc,3.47E+11,2023-04-10,138,0,395.51
2023-04-10,Misc,3.1E+11,2023-04-10,0,4000,4395.51
2023-04-10,Misc,3.1E+11,2023-04-10,3000,0,1395.51
2023-04-10,Misc,3.47E+11,2023-04-10,140,0,1255.51
2023-04-10,Food,3.47E+11,2023-04-10,20,0,1235.51
2023-04-11,Food,3.1E+11,2023-04-11,40,0,1195.51
2023-04-11,Food,3.47E+11,2023-04-11,65,0,1130.51
2023-04-11,Misc,3.47E+11,2023-04-11,140,0,990.51
2023-04-12,Food,3.47E+11,2023-04-12,20,0,970.51
2023-04-12,Food,3.47E+11,2023-04-12,46,0,924.51
2023-04-12,Misc,3.1E+11,2023-04-12,0,1000,1924.51
2023-04-12,Misc,3.1E+11,2023-04-12,0,300,2224.51
2023-04-12,Misc,3.47E+11,2023-04-12,185,0,2039.51
2023-04-12,Food,3.47E+11,2023-04-12,80,0,1959.51
2023-04-13,Food,3.47E+11,2023-04-13,72,0,1887.51
2023-04-13,Food,3.1E+11,2023-04-13,50,0,1837.51
2023-04-13,Food,3.1E+11,2023-04-13,25,0,1812.51
2023-04-13,Food,3.1E+11,2023-04-13,56,0,1756.51
2023-04-13,Food,3.47E+11,2023-04-13,220.68,0,1535.83
2023-04-13,Food,3.47E+11,2023-04-13,86,0,1449.83
2023-04-14,Food,3.47E+11,2023-04-14,65,0,1384.83
2023-04-14,Food,3.1E+11,2023-04-14,66,0,1318.83
2023-04-14,Food,3.47E+11,2023-04-14,100,0,1218.83
2023-04-14,Misc,3.47E+11,2023-04-14,160,0,1058.83
2023-04-14,Food,3.47E+11,2023-04-14,70,0,988.83
2023-04-15,Food,3.11E+11,2023-04-15,30,0,958.83
2023-04-15,Food,3.11E+11,2023-04-15,100,0,858.83
2023-04-15,Food,3.47E+11,2023-04-15,272.26,0,586.57
2023-04-15,Misc,3.47E+11,2023-04-15,110,0,476.57
2023-04-15,Food,3.47E+11,2023-04-15,75,0,401.57
2023-04-15,Food,3.47E+11,2023-04-15,40,0,361.57
2023-04-16,Misc,3.11E+11,2023-04-16,9,0,352.57
2023-04-16,Misc,3.47E+11,2023-04-16,0,500,852.57
2023-04-16,Misc,3.47E+11,2023-04-16,120,0,732.57
2023-04-16,Food,3.47E+11,2023-04-16,50,0,682.57
2023-04-16,Shopping,3.47E+11,2023-04-16,189,0,493.57
2023-04-16,Food,3.47E+11,2023-04-16,30,0,463.57
2023-04-16,Food,3.47E+11,2023-04-16,65,0,398.57
2023-04-16,Food,3.47E+11,2023-04-16,10,0,388.57
2023-04-16,Food,3.11E+11,2023-04-16,30,0,358.57
2023-04-16,Food,3.47E+11,2023-04-16,80,0,278.57
2023-04-16,Food,3.47E+11,2023-04-16,45,0,233.57
2023-04-17,Food,3.47E+11,2023-04-17,65,0,168.57
2023-04-17,Food,3.11E+11,2023-04-17,50,0,118.57
2023-04-17,Food,3.11E+11,2023-04-17,15.3,0,103.27
2023-04-17,Food,3.47E+11,2023-04-17,30,0,73.27
2023-04-18,Food,3.47E+11,2023-04-18,20,0,53.27
2023-04-19,Food,3.11E+11,2023-04-19,40,0,13.27
2023-04-19,Misc,3.48E+11,2023-04-19,0,35,48.27
2023-04-20,Misc,3.11E+11,2023-04-20,0,1180,1228.27
2023-04-20,Food,3.11E+11,2023-04-20,41,0,1187.27
2023-04-20,Food,3.11E+11,2023-04-20,20,0,1167.27
2023-04-20,Food,3.48E+11,2023-04-20,41,0,1126.27
2023-04-20,Food,3.48E+11,2023-04-20,90,0,1036.27
2023-04-20,Food,3.48E+11,2023-04-20,75,0,961.27
2023-04-21,Food,3.11E+11,2023-04-21,60,0,901.27
2023-04-21,Food,3.48E+11,2023-04-21,90,0,811.27
2023-04-21,Misc,3.48E+11,2023-04-21,130,0,681.27
2023-04-21,Food,3.48E+11,2023-04-21,231.4,0,449.87
2023-04-22,Food,3.11E+11,2023-04-22,40,0,409.87
2023-04-22,Misc,3.48E+11,2023-04-22,120,0,289.87
2023-04-22,Food,3.48E+11,2023-04-22,50,0,239.87
2023-04-22,Food,3.11E+11,2023-04-22,25,0,214.87
2023-04-22,Food,3.11E+11,2023-04-22,20,0,194.87
2023-04-22,Food,3.48E+11,2023-04-22,50,0,144.87
2023-04-22,Food,3.48E+11,2023-04-22,90,0,54.87
2023-04-22,Food,3.48E+11,2023-04-22,35,0,19.87
2023-04-22,Food,3.48E+11,2023-04-22,10,0,9.87
2023-04-23,Misc,3.11E+11,2023-04-23,0,1745,1754.87
2023-04-23,Misc,3.48E+11,2023-04-23,730,0,1024.87
2023-04-23,Food,3.48E+11,2023-04-23,20,0,1004.87
2023-04-23,Food,3.48E+11,2023-04-23,65,0,939.87
2023-04-24,Food,3.11E+11,2023-04-24,40,0,899.87
2023-04-24,Food,3.11E+11,2023-04-24,20,0,879.87
2023-04-24,Food,3.48E+11,2023-04-24,20,0,859.87
2023-04-24,Food,3.48E+11,2023-04-24,78,0,781.87
2023-04-24,Misc,3.11E+11,2023-04-24,0,539,1320.87
2023-04-24,Food,3.48E+11,2023-04-24,40,0,1280.87
2023-04-24,Food,3.48E+11,2023-04-24,85,0,1195.87
2023-04-24,Food,3.11E+11,2023-04-24,15.3,0,1180.57
2023-04-24,Food,3.48E+11,2023-04-24,30,0,1150.57
2023-04-24,Food,3.48E+11,2023-04-24,342.4,0,808.17
2023-04-24,Food,3.48E+11,2023-04-24,0,292.4,1100.57
2023-04-24,Food,3.48E+11,2023-04-24,205.45,0,895.12
2023-04-25,Food,3.12E+11,2023-04-25,29.3,0,865.82
2023-04-25,Salary,CHAST23111858452,2023-04-25,0,34800,35665.82
2023-04-25,Misc,3.12E+11,2023-04-25,10000,0,25665.82
2023-04-25,Misc,3.12E+11,2023-04-25,999,0,24666.82
2023-04-25,Misc,3.48E+11,2023-04-25,110,0,24556.82
2023-04-25,Food,3.48E+11,2023-04-25,50,0,24506.82
2023-04-25,Misc,3.12E+11,2023-04-25,1,0,24505.82
2023-04-25,Misc,3.12E+11,2023-04-25,4999,0,19506.82
2023-04-25,Misc,3.48E+11,2023-04-25,275,0,19231.82
2023-04-25,Misc,3.12E+11,2023-04-25,0,141,19372.82
2023-04-25,Food,3.48E+11,2023-04-25,92,0,19280.82
2023-04-25,Food,3.48E+11,2023-04-25,28,0,19252.82
2023-04-26,Shopping,3.12E+11,2023-04-26,399,0,18853.82
2023-04-26,Food,3.48E+11,2023-04-26,95,0,18758.82
2023-04-26,Shopping,3.48E+11,2023-04-26,539,0,18219.82
2023-04-26,Food,3.12E+11,2023-04-26,85,0,18134.82
2023-04-26,Misc,3.48E+11,2023-04-26,0,1000,19134.82
2023-04-26,Misc,3.48E+11,2023-04-26,120,0,19014.82
2023-04-26,Food,3.48E+11,2023-04-26,30,0,18984.82
2023-04-27,Food,3.12E+11,2023-04-27,30,0,18954.82
2023-04-27,Shopping,3.12E+11,2023-04-27,400,0,18554.82
2023-04-27,Misc,3.12E+11,2023-04-27,190,0,18364.82
2023-04-27,Shopping,3.12E+11,2023-04-27,0,400,18764.82
2023-04-27,Misc,3.12E+11,2023-04-27,2023,0,16741.82
2023-04-27,Food,3.12E+11,2023-04-27,15,0,16726.82
2023-04-27,Food,3.12E+11,2023-04-27,287.95,0,16438.87
2023-04-27,Shopping,3.48E+11,2023-04-27,700,0,15738.87
2023-04-27,Food,3.48E+11,2023-04-27,20,0,15718.87
2023-04-27,Food,3.12E+11,2023-04-27,100,0,15618.87
2023-04-27,Food,3.48E+11,2023-04-27,100,0,15518.87
2023-04-27,Food,3.48E+11,2023-04-27,28,0,15490.87
2023-04-28,Food,3.12E+11,2023-04-28,10,0,15480.87
2023-04-28,Food,3.12E+11,2023-04-28,70,0,15410.87
2023-04-28,Food,3.12E+11,2023-04-28,10,0,15400.87
2023-04-28,Misc,3.48E+11,2023-04-28,180,0,15220.87
2023-04-28,Misc,3.48E+11,2023-04-28,0,120,15340.87
2023-04-28,Food,3.48E+11,2023-04-28,30,0,15310.87
2023-04-28,Food,3.48E+11,2023-04-28,75,0,15235.87
2023-04-28,Food,3.48E+11,2023-04-28,42,0,15193.87
2023-04-28,Misc,3.48E+11,2023-04-28,180,0,15013.87
2023-04-28,Misc,3.12E+11,2023-04-28,0,90,15103.87
2023-04-28,Food,3.48E+11,2023-04-28,35,0,15068.87
2023-04-28,Food,3.48E+11,2023-04-28,30,0,15038.87
2023-04-29,Misc,3.49E+11,2023-04-29,220,0,14818.87
2023-04-29,Food,3.49E+11,2023-04-29,40,0,14778.87
2023-04-29,Food,3.12E+11,2023-04-29,75,0,14703.87
2023-04-29,Misc,3.49E+11,2023-04-29,280,0,14423.87
2023-04-29,Misc,3.49E+11,2023-04-29,120,0,14303.87
2023-04-29,Food,3.49E+11,2023-04-29,60,0,14243.87
2023-04-29,Food,3.49E+11,2023-04-29,40,0,14203.87
2023-04-30,Food,3.12E+11,2023-04-30,64,0,14139.87
2023-04-30,Food,3.12E+11,2023-04-30,80,0,14059.87
2023-04-30,Shopping,3.49E+11,2023-04-30,1044,0,13015.87
2023-04-30,Food,3.49E+11,2023-04-30,300.35,0,12715.52
2023-04-30,Food,3.49E+11,2023-04-30,85,0,12630.52
2023-04-30,Misc,3.49E+11,2023-05-01,152,0,12478.52
2023-04-30,Food,3.49E+11,2023-05-01,50,0,12428.52
2023-05-01,Rent,3.12E+11,2023-05-01,6463,0,5965.52
2023-05-01,Food,3.12E+11,2023-05-01,65,0,5900.52
2023-05-01,Misc,3.12E+11,2023-05-01,0,350,6250.52
2023-05-01,Misc,3.12E+11,2023-05-01,240,0,6010.52
2023-05-01,Misc,3.12E+11,2023-05-01,0,120,6130.52
2023-05-01,Food,3.12E+11,2023-05-01,35,0,6095.52
2023-05-01,Food,3.49E+11,2023-05-01,30,0,6065.52
2023-05-01,Food,3.49E+11,2023-05-01,30,0,6035.52
2023-05-01,Food,3.49E+11,2023-05-01,80,0,5955.52
2023-05-02,Food,3.49E+11,2023-05-02,260.35,0,5695.17
2023-05-02,Food,3.49E+11,2023-05-02,50,0,5645.17
2023-05-02,Food,3.12E+11,2023-05-02,10,0,5635.17
2023-05-02,Misc,3.49E+11,2023-05-02,150,0,5485.17
2023-05-02,Misc,3.49E+11,2023-05-02,0,75,5560.17
2023-05-02,Food,3.49E+11,2023-05-02,45,0,5515.17
2023-05-02,Food,3.49E+11,2023-05-02,30,0,5485.17
2023-05-02,Misc,3.49E+11,2023-05-03,1391.16,0,4094.01
2023-05-03,Food,3.49E+11,2023-05-03,69,0,4025.01
2023-05-03,Food,3.49E+11,2023-05-03,40,0,3985.01
2023-05-03,Food,3.49E+11,2023-05-03,85,0,3900.01
2023-05-03,Misc,3.49E+11,2023-05-03,180,0,3720.01
2023-05-03,Food,3.49E+11,2023-05-03,20,0,3700.01
2023-05-04,Food,3.49E+11,2023-05-04,26,0,3674.01
2023-05-04,Food,3.12E+11,2023-05-04,10,0,3664.01
2023-05-04,Food,3.49E+11,2023-05-04,30,0,3634.01
2023-05-04,Food,3.12E+11,2023-05-04,10,0,3624.01
2023-05-04,Food,3.12E+11,2023-05-04,396.9,0,3227.11
2023-05-04,Food,3.49E+11,2023-05-04,20,0,3207.11
2023-05-04,Food,3.12E+11,2023-05-04,64,0,3143.11
2023-05-05,Misc,3.49E+11,2023-05-05,0,95,3238.11
2023-05-05,Misc,3.49E+11,2023-05-05,175,0,3063.11
2023-05-05,Food,3.49E+11,2023-05-05,40,0,3023.11
2023-05-05,Food,3.13E+11,2023-05-05,76,0,2947.11
2023-05-05,Food,3.13E+11,2023-05-05,100,0,2847.11
2023-05-05,Misc,3.49E+11,2023-05-05,933,0,1914.11
2023-05-05,Food,3.49E+11,2023-05-05,40,0,1874.11
2023-05-06,Food,3.13E+11,2023-05-06,77,0,1797.11
2023-05-06,Food,3.13E+11,2023-05-06,44,0,1753.11
2023-05-06,Misc,3.13E+11,2023-05-06,150,0,1603.11
2023-05-06,Food,3.13E+11,2023-05-06,40,0,1563.11
2023-05-06,Misc,3.49E+11,2023-05-06,240,0,1323.11
2023-05-06,Food,3.49E+11,2023-05-06,30,0,1293.11
2023-05-06,Misc,3.49E+11,2023-05-06,113,0,1180.11
2023-05-07,Food,3.49E+11,2023-05-07,48,0,1132.11
2023-05-07,Misc,3.13E+11,2023-05-07,0,1132,2264.11
2023-05-07,Misc,3.49E+11,2023-05-07,0,136,2400.11
2023-05-07,Misc,3.49E+11,2023-05-07,0,636,3036.11
2023-05-07,Food,3.49E+11,2023-05-07,80,0,2956.11
2023-05-07,Food,3.49E+11,2023-05-07,10,0,2946.11
2023-05-07,Misc,3.49E+11,2023-05-07,0,936,3882.11
2023-05-07,Food,3.49E+11,2023-05-07,52,0,3830.11
2023-05-07,Food,3.49E+11,2023-05-07,20,0,3810.11
2023-05-07,Misc,3.49E+11,2023-05-07,0,681,4491.11
2023-05-08,Food,3.49E+11,2023-05-08,65,0,4426.11
2023-05-08,Food,3.49E+11,2023-05-08,40,0,4386.11
2023-05-08,Food,3.49E+11,2023-05-08,75,0,4311.11
2023-05-09,Food,3.13E+11,2023-05-09,40,0,4271.11
2023-05-09,Food,3.13E+11,2023-05-09,90,0,4181.11
2023-05-09,Food,3.13E+11,2023-05-09,10,0,4171.11
2023-05-09,Food,3.5E+11,2023-05-09,247.75,0,3923.36
2023-05-09,Food,3.5E+11,2023-05-09,100,0,3823.36
2023-05-09,Misc,3.13E+11,2023-05-09,0,10,3833.36
2023-05-09,Food,3.13E+11,2023-05-09,35,0,3798.36
2023-05-09,Misc,3.5E+11,2023-05-09,398,0,3400.36
2023-05-09,Misc,3.13E+11,2023-05-09,0,155,3555.36
2023-05-09,Food,3.5E+11,2023-05-09,60,0,3495.36
2023-05-10,Food,3.5E+11,2023-05-10,0,10,3505.36
2023-05-10,Misc,3.13E+11,2023-05-10,0,70,3575.36
2023-05-10,Misc,3.13E+11,2023-05-10,139,0,3436.36
2023-05-10,Misc,3.5E+11,2023-05-10,500,0,2936.36
2023-05-10,Misc,3.13E+11,2023-05-10,0,500,3436.36
2023-05-10,Food,3.5E+11,2023-05-10,40,0,3396.36
2023-05-10,Misc,3.5E+11,2023-05-10,284,0,3112.36
2023-05-11,Food,3.5E+11,2023-05-11,85,0,3027.36
2023-05-11,Food,3.5E+11,2023-05-11,50,0,2977.36
2023-05-11,Food,3.5E+11,2023-05-11,75,0,2902.36
2023-05-11,Misc,3.5E+11,2023-05-11,326,0,2576.36
2023-05-11,Food,3.5E+11,2023-05-11,36,0,2540.36
2023-05-12,Misc,3.5E+11,2023-05-12,0,95,2635.36
2023-05-12,Misc,3.5E+11,2023-05-12,380,0,2255.36
2023-05-12,Misc,3.5E+11,2023-05-12,0,190,2445.36
2023-05-12,Food,3.5E+11,2023-05-12,50,0,2395.36
2023-05-12,Food,3.5E+11,2023-05-12,41,0,2354.36
2023-05-12,Misc,3.13E+11,2023-05-12,1041,0,1313.36
2023-05-12,Food,3.13E+11,2023-05-12,41,0,1272.36
2023-05-12,Food,3.5E+11,2023-05-12,20,0,1252.36
2023-05-12,Food,3.5E+11,2023-05-12,30,0,1222.36
2023-05-12,Misc,3.5E+11,2023-05-12,385,0,837.36
2023-05-12,Misc,3.5E+11,2023-05-12,0,105,942.36
2023-05-13,Misc,3.13E+11,2023-05-13,0,130,1072.36
2023-05-13,Misc,3.5E+11,2023-05-13,125,0,947.36
2023-05-13,Food,3.5E+11,2023-05-13,40,0,907.36
2023-05-13,Misc,3.5E+11,2023-05-13,120,0,787.36
2023-05-14,Misc,3.5E+11,2023-05-14,121,0,666.36
2023-05-14,Food,3.13E+11,2023-05-14,40,0,626.36
2023-05-14,Food,3.5E+11,2023-05-14,60,0,566.36
2023-05-14,Misc,3.13E+11,2023-05-14,154.5,0,411.86
2023-05-14,Food,3.13E+11,2023-05-14,45,0,366.86
2023-05-14,Food,3.5E+11,2023-05-14,75,0,291.86
2023-05-14,Misc,3.13E+11,2023-05-14,0,60,351.86
2023-05-14,Misc,3.13E+11,2023-05-14,0,120,471.86
2023-05-15,Misc,3.14E+11,2023-05-15,0,500,971.86
2023-05-15,Food,3.5E+11,2023-05-15,65,0,906.86
2023-05-15,Food,3.5E+11,2023-05-15,50,0,856.86
2023-05-15,Food,3.5E+11,2023-05-15,65,0,791.86
2023-05-16,Food,3.14E+11,2023-05-16,54,0,737.86
2023-05-16,Misc,3.5E+11,2023-05-16,140,0,597.86
2023-05-16,Food,3.5E+11,2023-05-16,60,0,537.86
2023-05-16,Food,3.5E+11,2023-05-16,30,0,507.86
2023-05-16,Food,3.14E+11,2023-05-16,20,0,487.86
2023-05-16,Misc,3.5E+11,2023-05-16,101,0,386.86
2023-05-17,Food,3.5E+11,2023-05-17,75,0,311.86
2023-05-17,Food,3.14E+11,2023-05-17,60,0,251.86
2023-05-17,Food,3.5E+11,2023-05-17,54,0,197.86
2023-05-17,Misc,3.5E+11,2023-05-17,150,0,47.86
2023-05-17,Food,3.5E+11,2023-05-17,40,0,7.86
2023-05-18,Misc,3.5E+11,2023-05-18,0,170,177.86
2023-05-18,Food,3.5E+11,2023-05-18,80,0,97.86
2023-05-18,Misc,3.5E+11,2023-05-18,0,1000,1097.86
2023-05-18,Food,3.5E+11,2023-05-18,55,0,1042.86
2023-05-18,Food,3.5E+11,2023-05-18,44,0,998.86
2023-05-19,Food,3.14E+11,2023-05-19,50,0,948.86
2023-05-19,Misc,3.51E+11,2023-05-19,140,0,808.86
2023-05-19,Food,3.14E+11,2023-05-19,30,0,778.86
2023-05-19,Food,3.51E+11,2023-05-19,76,0,702.86
2023-05-20,Misc,3.51E+11,2023-05-20,500,0,202.86
2023-05-20,Food,3.51E+11,2023-05-20,33,0,169.86
2023-05-20,Food,3.14E+11,2023-05-20,58,0,111.86
2023-05-20,Food,3.14E+11,2023-05-20,95,0,16.86
2023-05-21,Misc,3.51E+11,2023-05-21,0,110,126.86
2023-05-22,Food,3.51E+11,2023-05-22,10,0,116.86
2023-05-23,Food,3.51E+11,2023-05-23,72,0,44.86
2023-05-23,Misc,3.14E+11,2023-05-23,0,300,344.86
2023-05-23,Food,3.14E+11,2023-05-23,90,0,254.86
2023-05-23,Food,3.51E+11,2023-05-23,30,0,224.86
2023-05-24,Food,3.51E+11,2023-05-24,30,0,194.86
2023-05-25,Salary,CHASU23143454301,2023-05-25,0,34800,34994.86
2023-05-25,Misc,3.15E+11,2023-05-25,1000,0,33994.86
2023-05-25,Misc,3.15E+11,2023-05-25,10000,0,23994.86
2023-05-25,Misc,3.51E+11,2023-05-25,270,0,23724.86
2023-05-25,Food,3.51E+11,2023-05-25,40,0,23684.86
2023-05-25,Food,3.51E+11,2023-05-25,72,0,23612.86
2023-05-25,Food,3.51E+11,2023-05-25,20,0,23592.86
2023-05-25,Food,3.51E+11,2023-05-25,363.9,0,23228.96
2023-05-25,Misc,3.51E+11,2023-05-25,10000,0,13228.96
2023-05-25,Food,3.51E+11,2023-05-25,40,0,13188.96
2023-05-26,Misc,3.15E+11,2023-05-26,0,10,13198.96
2023-05-26,Misc,3.15E+11,2023-05-26,239,0,12959.96
2023-05-26,Food,3.51E+11,2023-05-26,65,0,12894.96
2023-05-26,Food,3.15E+11,2023-05-26,50,0,12844.96
2023-05-26,Misc,3.51E+11,2023-05-26,2185,0,10659.96
2023-05-26,Misc,3.51E+11,2023-05-26,200,0,10459.96
2023-05-26,Misc,3.51E+11,2023-05-26,115,0,10344.96
2023-05-26,Misc,3.51E+11,2023-05-26,204,0,10140.96
2023-05-27,Food,3.15E+11,2023-05-27,10,0,10130.96
2023-05-27,Food,3.15E+11,2023-05-27,10,0,10120.96
2023-05-27,Misc,3.51E+11,2023-05-27,307,0,9813.96
2023-05-27,Misc,3.51E+11,2023-05-27,0,675,10488.96
2023-05-27,Misc,3.51E+11,2023-05-27,1500,0,8988.96
2023-05-27,Misc,3.51E+11,2023-05-27,180,0,8808.96
2023-05-27,Food,3.51E+11,2023-05-27,20,0,8788.96
2023-05-27,Misc,3.15E+11,2023-05-27,0,675,9463.96
2023-05-28,Shopping,3.51E+11,2023-05-28,197,0,9266.96
2023-05-28,Food,3.51E+11,2023-05-28,80,0,9186.96
2023-05-28,Food,3.51E+11,2023-05-28,100,0,9086.96
2023-05-28,Food,3.51E+11,2023-05-28,55,0,9031.96
2023-05-28,Misc,3.15E+11,2023-05-28,364,0,8667.96
2023-05-28,Shopping,3.15E+11,2023-05-28,186,0,8481.96
2023-05-28,Food,3.51E+11,2023-05-28,30,0,8451.96
2023-06-01,Shopping,3.15E+11,2023-06-01,0,186,8637.96
2023-06-02,Food,3.52E+11,2023-06-02,30,0,8607.96
2023-06-02,Misc,3.52E+11,2023-06-02,160,0,8447.96
2023-06-02,Food,3.52E+11,2023-06-02,90,0,8357.96
2023-06-03,Shopping,3.15E+11,2023-06-03,454,0,7903.96
2023-06-03,Food,3.15E+11,2023-06-03,30,0,7873.96
2023-06-03,Misc,3.52E+11,2023-06-03,170.01,0,7703.95
2023-06-03,Misc,3.52E+11,2023-06-03,105,0,7598.95
2023-06-03,Food,3.15E+11,2023-06-03,35,0,7563.95
2023-06-03,Food,3.15E+11,2023-06-03,20,0,7543.95
2023-06-03,Misc,3.15E+11,2023-06-03,0,130,7673.95
2023-06-03,Food,3.52E+11,2023-06-03,36,0,7637.95
2023-06-03,Misc,3.52E+11,2023-06-03,390,0,7247.95
2023-06-03,Food,3.52E+11,2023-06-03,50,0,7197.95
2023-06-04,Food,3.52E+11,2023-06-04,35,0,7162.95
2023-06-04,Misc,3.52E+11,2023-06-04,963,0,6199.95
2023-06-04,Misc,3.52E+11,2023-06-04,0,190,6389.95
2023-06-04,Food,3.16E+11,2023-06-04,65,0,6324.95
2023-06-04,Food,3.52E+11,2023-06-04,384.9,0,5940.05
2023-06-04,Food,3.52E+11,2023-06-04,20,0,5920.05
2023-06-05,Food,3.16E+11,2023-06-05,34,0,5886.05
2023-06-05,Food,3.52E+11,2023-06-05,65,0,5821.05
2023-06-05,Food,3.16E+11,2023-06-05,40,0,5781.05
2023-06-05,Misc,3.52E+11,2023-06-05,628,0,5153.05
2023-06-05,Misc,3.52E+11,2023-06-05,8,0,5145.05
2023-06-06,Food,3.52E+11,2023-06-06,30,0,5115.05
2023-06-06,Food,3.52E+11,2023-06-06,251.25,0,4863.8
2023-06-06,Food,3.52E+11,2023-06-06,20,0,4843.8
2023-06-06,Food,3.52E+11,2023-06-06,50,0,4793.8
2023-06-06,Food,3.52E+11,2023-06-06,14.25,0,4779.55
2023-06-06,Misc,3.16E+11,2023-06-06,150,0,4629.55
2023-06-06,Misc,3.52E+11,2023-06-06,515,0,4114.55
2023-06-06,Food,3.52E+11,2023-06-07,50,0,4064.55
2023-06-07,Food,3.52E+11,2023-06-07,80,0,3984.55
2023-06-07,Food,3.52E+11,2023-06-07,40,0,3944.55
2023-06-07,Food,3.16E+11,2023-06-07,40,0,3904.55
2023-06-07,Food,3.16E+11,2023-06-07,40,0,3864.55
2023-06-07,Misc,3.52E+11,2023-06-07,0,1600,5464.55
2023-06-07,Misc,3.52E+11,2023-06-07,130,0,5334.55
2023-06-08,Food,3.16E+11,2023-06-08,34,0,5300.55
2023-06-08,Misc,3.53E+11,2023-06-08,125,0,5175.55
2023-06-08,Misc,3.53E+11,2023-06-08,0,65,5240.55
2023-06-08,Food,3.16E+11,2023-06-08,10,0,5230.55
2023-06-08,Food,3.53E+11,2023-06-08,50,0,5180.55
2023-06-08,Food,3.16E+11,2023-06-08,50,0,5130.55
2023-06-08,Food,3.53E+11,2023-06-08,70,0,5060.55
2023-06-08,Food,3.53E+11,2023-06-08,40,0,5020.55
2023-06-09,Misc,3.16E+11,2023-06-09,0,72,5092.55
2023-06-09,Misc,3.53E+11,2023-06-09,137,0,4955.55
2023-06-09,Misc,3.53E+11,2023-06-09,0,171,5126.55
2023-06-09,Food,3.53E+11,2023-06-09,50,0,5076.55
2023-06-09,Food,3.16E+11,2023-06-09,60,0,5016.55
2023-06-09,Misc,3.53E+11,2023-06-09,0,8000,13016.55
2023-06-09,Misc,3.53E+11,2023-06-09,8000,0,5016.55
2023-06-09,Misc,3.53E+11,2023-06-09,125,0,4891.55
2023-06-10,Food,3.53E+11,2023-06-10,40,0,4851.55
2023-06-10,Food,3.53E+11,2023-06-10,70,0,4781.55
2023-06-10,Misc,3.16E+11,2023-06-10,150,0,4631.55
2023-06-10,Misc,3.53E+11,2023-06-10,344,0,4287.55
2023-06-10,Food,3.53E+11,2023-06-10,30,0,4257.55
2023-06-11,Misc,3.53E+11,2023-06-11,450,0,3807.55
2023-06-11,Misc,3.53E+11,2023-06-11,350,0,3457.55
2023-06-11,Misc,3.53E+11,2023-06-11,140,0,3317.55
2023-06-12,Food,3.53E+11,2023-06-12,44,0,3273.55
2023-06-12,Food,3.53E+11,2023-06-12,40,0,3233.55
2023-06-12,Misc,3.16E+11,2023-06-12,0,3000,6233.55
2023-06-12,Misc,3.16E+11,2023-06-12,3000,0,3233.55
2023-06-12,Food,3.16E+11,2023-06-12,34,0,3199.55
2023-06-12,Food,3.53E+11,2023-06-12,50,0,3149.55
2023-06-12,Food,3.53E+11,2023-06-12,25,0,3124.55
2023-06-12,Food,3.53E+11,2023-06-12,56,0,3068.55
2023-06-13,Food,3.53E+11,2023-06-13,55,0,3013.55
2023-06-13,Food,3.53E+11,2023-06-13,30,0,2983.55
2023-06-13,Food,3.53E+11,2023-06-13,50,0,2933.55
2023-06-13,Food,3.53E+11,2023-06-13,100,0,2833.55
2023-06-13,Food,3.16E+11,2023-06-13,20,0,2813.55
2023-06-13,Food,3.16E+11,2023-06-13,30,0,2783.55
2023-06-13,Misc,3.53E+11,2023-06-13,0,1000,3783.55
2023-06-13,Food,3.53E+11,2023-06-13,28,0,3755.55
2023-06-14,Food,3.17E+11,2023-06-14,40,0,3715.55
2023-06-14,Misc,3.53E+11,2023-06-14,1100,0,2615.55
2023-06-14,Misc,3.17E+11,2023-06-14,125,0,2490.55
2023-06-14,Food,3.17E+11,2023-06-14,100,0,2390.55
2023-06-14,Misc,3.53E+11,2023-06-14,385,0,2005.55
2023-06-14,Misc,3.17E+11,2023-06-14,750,0,1255.55
2023-06-15,Food,3.17E+11,2023-06-15,10,0,1245.55
2023-06-15,Misc,3.17E+11,2023-06-15,138,0,1107.55
2023-06-15,Food,3.17E+11,2023-06-15,10,0,1097.55
2023-06-16,Food,3.17E+11,2023-06-16,100,0,997.55
2023-06-16,Food,3.17E+11,2023-06-16,60,0,937.55
2023-06-16,Food,3.53E+11,2023-06-16,100,0,837.55
2023-06-17,Food,3.53E+11,2023-06-17,60,0,777.55
2023-06-17,Food,3.53E+11,2023-06-17,10,0,767.55
2023-06-18,Food,3.17E+11,2023-06-18,20,0,747.55
2023-06-18,Food,3.17E+11,2023-06-18,10,0,737.55
2023-06-18,Food,3.54E+11,2023-06-18,20,0,717.55
2023-06-18,Food,3.54E+11,2023-06-18,40,0,677.55
2023-06-18,Food,3.54E+11,2023-06-18,50,0,627.55
2023-06-19,Food,3.54E+11,2023-06-19,20,0,607.55
2023-06-19,Misc,3.17E+11,2023-06-19,0,400,1007.55
2023-06-19,Misc,3.54E+11,2023-06-19,327,0,680.55
2023-06-20,Food,3.54E+11,2023-06-20,25,0,655.55
2023-06-21,Food,3.54E+11,2023-06-21,20,0,635.55
2023-06-21,Food,3.54E+11,2023-06-21,55,0,580.55
2023-06-21,Food,3.54E+11,2023-06-21,40,0,540.55
2023-06-21,Food,3.54E+11,2023-06-21,10,0,530.55
2023-06-21,Food,3.54E+11,2023-06-21,20,0,510.55
2023-06-21,Misc,3.17E+11,2023-06-21,8.26,0,502.29
2023-06-23,Salary,CHASU23172917734,2023-06-23,0,34800,35302.29
2023-06-23,Misc,3.17E+11,2023-06-23,2000,0,33302.29
2023-06-23,Misc,3.54E+11,2023-06-23,3000,0,30302.29
2023-06-24,Misc,3.18E+11,2023-06-24,10000,0,20302.29
2023-06-24,Misc,3.18E+11,2023-06-24,1000,0,19302.29
2023-06-24,Food,3.18E+11,2023-06-24,100,0,19202.29
2023-06-24,Misc,3.18E+11,2023-06-24,409,0,18793.29
2023-06-24,Misc,3.18E+11,2023-06-24,200,0,18593.29
2023-06-24,Misc,3.18E+11,2023-06-24,424,0,18169.29
2023-06-25,Misc,3.54E+11,2023-06-25,600,0,17569.29
2023-06-25,Food,3.54E+11,2023-06-25,100,0,17469.29
2023-06-26,Misc,3.54E+11,2023-06-26,5000,0,12469.29
2023-06-26,Misc,3.18E+11,2023-06-26,528.44,0,11940.85
2023-06-26,Misc,3.18E+11,2023-06-26,0,1,11941.85
2023-06-27,Food,3.54E+11,2023-06-27,100,0,11841.85
2023-06-27,Misc,3.18E+11,2023-06-27,2100,0,9741.85
2023-06-27,Misc,3.54E+11,2023-06-27,119,0,9622.85
2023-06-28,Misc,3.18E+11,2023-06-28,500,0,9122.85
2023-06-28,Misc,3.55E+11,2023-06-28,7630,0,1492.85
2023-06-30,Misc,3.55E+11,2023-06-30,467,0,1025.85
2023-07-01,Misc,0,2023-06-30,0,34,1059.85
2023-07-01,Food,3.55E+11,2023-07-01,20,0,1039.85
2023-07-01,Food,3.18E+11,2023-07-01,20,0,1019.85
2023-07-01,Food,3.18E+11,2023-07-01,20,0,999.85
2023-07-02,Misc,3.18E+11,2023-07-01,0,10,1009.85
2023-07-04,Misc,3.55E+11,2023-07-04,125,0,884.85
2023-07-05,Food,3.55E+11,2023-07-05,40,0,844.85
2023-07-05,Food,3.19E+11,2023-07-05,50,0,794.85
2023-07-08,Misc,3.07E+11,2023-07-08,0,1.13,795.98
2023-07-08,Food,3.56E+11,2023-07-08,50,0,745.98
2023-07-08,Misc,3.56E+11,2023-07-08,0,7800,8545.98
2023-07-08,Misc,3.56E+11,2023-07-09,7800,0,745.98
2023-07-09,Shopping,3.19E+11,2023-07-09,184,0,561.98
2023-07-10,Misc,3.56E+11,2023-07-10,0,2500,3061.98
2023-07-10,Food,3.19E+11,2023-07-10,100,0,2961.98
2023-07-10,Misc,3.19E+11,2023-07-10,1100,0,1861.98
2023-07-10,Food,3.56E+11,2023-07-10,30,0,1831.98
2023-07-11,Food,3.19E+11,2023-07-11,20,0,1811.98
2023-07-11,Misc,3.19E+11,2023-07-11,170,0,1641.98
2023-07-11,Misc,3.19E+11,2023-07-11,140,0,1501.98
2023-07-11,Food,3.19E+11,2023-07-11,20,0,1481.98
2023-07-11,Food,3.19E+11,2023-07-11,20,0,1461.98
2023-07-12,Misc,3.07E+11,2023-07-12,0,125.96,1587.94
2023-07-12,Misc,3.56E+11,2023-07-12,125,0,1462.94
2023-07-12,Food,3.19E+11,2023-07-12,24,0,1438.94
2023-07-12,Food,3.19E+11,2023-07-12,10,0,1428.94
2023-07-12,Food,3.19E+11,2023-07-12,30,0,1398.94
2023-07-13,Food,3.19E+11,2023-07-13,60,0,1338.94
2023-07-13,Food,3.56E+11,2023-07-13,198.32,0,1140.62
2023-07-13,Food,3.19E+11,2023-07-13,50,0,1090.62
2023-07-13,Food,3.19E+11,2023-07-13,50,0,1040.62
2023-07-13,Food,3.19E+11,2023-07-13,20,0,1020.62
2023-07-13,Food,3.19E+11,2023-07-13,10,0,1010.62
2023-07-14,Misc,3.2E+11,2023-07-14,5,0,1005.62
2023-07-14,Misc,3.2E+11,2023-07-14,270,0,735.62
2023-07-14,Food,3.2E+11,2023-07-14,70,0,665.62
2023-07-14,Food,3.2E+11,2023-07-14,10,0,655.62
2023-07-14,Food,3.2E+11,2023-07-14,40,0,615.62
2023-07-14,Food,3.2E+11,2023-07-14,71,0,544.62
2023-07-15,Food,3.2E+11,2023-07-15,40,0,504.62
2023-07-15,Food,3.2E+11,2023-07-15,40,0,464.62
2023-07-15,Misc,3.2E+11,2023-07-15,345,0,119.62
2023-07-16,Food,3.2E+11,2023-07-16,20,0,99.62
2023-07-16,Food,3.2E+11,2023-07-16,40,0,59.62
2023-07-16,Food,3.2E+11,2023-07-16,20,0,39.62
2023-07-17,Food,3.2E+11,2023-07-17,30,0,9.62
2023-07-19,Misc,3.57E+11,2023-07-19,0,1000,1009.62
2023-07-20,Food,3.2E+11,2023-07-20,100,0,909.62
2023-07-20,Food,3.2E+11,2023-07-20,30,0,879.62
2023-07-20,Food,3.2E+11,2023-07-20,70,0,809.62
2023-07-20,Food,3.2E+11,2023-07-20,50,0,759.62
2023-07-20,Food,3.2E+11,2023-07-20,40,0,719.62
2023-07-20,Misc,3.2E+11,2023-07-20,207,0,512.62
2023-07-21,Food,3.2E+11,2023-07-21,92,0,420.62
2023-07-21,Misc,3.2E+11,2023-07-21,250,0,170.62
2023-07-21,Misc,3.2E+11,2023-07-21,0,1000,1170.62
2023-07-21,Food,3.2E+11,2023-07-21,58,0,1112.62
2023-07-21,Misc,3.2E+11,2023-07-21,220,0,892.62
2023-07-21,Food,3.2E+11,2023-07-21,50,0,842.62
2023-07-22,Food,3.2E+11,2023-07-22,100,0,742.62
2023-07-22,Food,3.2E+11,2023-07-22,41,0,701.62
2023-07-22,Food,3.2E+11,2023-07-22,41,0,660.62
2023-07-22,Food,3.2E+11,2023-07-22,50,0,610.62
2023-07-22,Food,3.2E+11,2023-07-22,90,0,520.62
2023-07-22,Food,3.2E+11,2023-07-22,40,0,480.62
2023-07-22,Food,3.2E+11,2023-07-22,10,0,470.62
2023-07-22,Food,3.2E+11,2023-07-22,30,0,440.62
2023-07-23,Misc,3.57E+11,2023-07-23,0,500,940.62
2023-07-23,Food,3.2E+11,2023-07-23,10,0,930.62
2023-07-23,Misc,3.2E+11,2023-07-23,160,0,770.62
2023-07-23,Food,3.2E+11,2023-07-23,30,0,740.62
2023-07-23,Food,3.2E+11,2023-07-23,30,0,710.62
2023-07-23,Misc,3.2E+11,2023-07-23,180,0,530.62
2023-07-23,Food,3.2E+11,2023-07-23,51,0,479.62
2023-07-23,Food,3.2E+11,2023-07-23,10,0,469.62
2023-07-24,Food,3.21E+11,2023-07-24,20,0,449.62
2023-07-24,Food,3.21E+11,2023-07-24,20,0,429.62
2023-07-24,Misc,3.21E+11,2023-07-24,170,0,259.62
2023-07-24,Food,3.21E+11,2023-07-24,50,0,209.62
2023-07-24,Food,3.21E+11,2023-07-24,50,0,159.62
2023-07-25,Salary,CHASV23202393703,2023-07-25,0,34800,34959.62
2023-07-25,Shopping,3.21E+11,2023-07-25,2553,0,32406.62
2023-07-25,Misc,3.21E+11,2023-07-25,10000,0,22406.62
2023-07-25,Food,3.57E+11,2023-07-25,50,0,22356.62
2023-07-25,Misc,3.21E+11,2023-07-25,1001,0,21355.62
2023-07-25,Misc,3.21E+11,2023-07-25,130,0,21225.62
2023-07-25,Food,3.21E+11,2023-07-25,60,0,21165.62
2023-07-25,Misc,3.21E+11,2023-07-25,7500,0,13665.62
2023-07-25,Food,3.21E+11,2023-07-25,70,0,13595.62
2023-07-25,Misc,3.21E+11,2023-07-25,350,0,13245.62
2023-07-25,Food,3.21E+11,2023-07-25,30,0,13215.62
2023-07-25,Shopping,3.57E+11,2023-07-26,259,0,12956.62
2023-07-26,Shopping,3.21E+11,2023-07-26,0,259,13215.62
2023-07-26,Shopping,3.21E+11,2023-07-26,249,0,12966.62
2023-07-26,Misc,3.21E+11,2023-07-26,1000,0,11966.62
2023-07-26,Food,3.21E+11,2023-07-26,40,0,11926.62
2023-07-26,Misc,3.21E+11,2023-07-26,1500,0,10426.62
2023-07-26,Misc,3.21E+11,2023-07-26,150,0,10276.62
2023-07-26,Food,3.21E+11,2023-07-26,60,0,10216.62
2023-07-26,Misc,3.21E+11,2023-07-26,480,0,9736.62
2023-07-26,Food,3.21E+11,2023-07-26,40,0,9696.62
2023-07-26,Misc,3.21E+11,2023-07-26,200,0,9496.62
2023-07-27,Misc,3.21E+11,2023-07-27,108,0,9388.62
2023-07-27,Food,3.21E+11,2023-07-27,100,0,9288.62
2023-07-27,Misc,3.21E+11,2023-07-27,175,0,9113.62
2023-07-27,Misc,3.21E+11,2023-07-27,150,0,8963.62
2023-07-27,Food,3.21E+11,2023-07-27,20,0,8943.62
2023-07-27,Food,3.21E+11,2023-07-27,30,0,8913.62
2023-07-27,Misc,3.21E+11,2023-07-27,5,0,8908.62
2023-07-27,Shopping,3.57E+11,2023-07-27,199,0,8709.62
2023-07-27,Food,3.21E+11,2023-07-27,75,0,8634.62
2023-07-27,Food,3.21E+11,2023-07-27,20,0,8614.62
2023-07-28,Food,3.58E+11,2023-07-28,30,0,8584.62
2023-07-28,Food,3.21E+11,2023-07-28,23,0,8561.62
2023-07-28,Food,3.21E+11,2023-07-28,10,0,8551.62
2023-07-28,Food,3.21E+11,2023-07-28,60,0,8491.62
2023-07-29,Food,3.21E+11,2023-07-29,50,0,8441.62
2023-07-29,Food,3.21E+11,2023-07-29,40,0,8401.62
2023-07-29,Misc,3.21E+11,2023-07-29,160,0,8241.62
2023-07-29,Misc,3.21E+11,2023-07-29,320,0,7921.62
2023-07-30,Food,3.21E+11,2023-07-30,50,0,7871.62
2023-07-30,Misc,3.21E+11,2023-07-30,170,0,7701.62
2023-07-30,Food,3.21E+11,2023-07-30,20,0,7681.62
2023-07-30,Food,3.21E+11,2023-07-30,30,0,7651.62
2023-07-30,Food,3.21E+11,2023-07-30,20,0,7631.62
2023-07-31,Misc,3.21E+11,2023-07-31,110,0,7521.62
2023-08-01,Misc,MIR2421393691857,2023-08-01,236,0,7285.62
2023-08-01,Food,3.21E+11,2023-08-01,15,0,7270.62
2023-08-01,Food,3.21E+11,2023-08-01,30,0,7240.62
2023-08-02,Misc,3.21E+11,2023-08-02,0,2000,9240.62
2023-08-02,Rent,3.21E+11,2023-08-02,7459,0,1781.62
2023-08-02,Misc,3.21E+11,2023-08-02,243,0,1538.62
2023-08-02,Misc,3.21E+11,2023-08-02,999,0,539.62
2023-08-02,Food,3.21E+11,2023-08-02,10,0,529.62
2023-08-02,Food,3.21E+11,2023-08-02,90,0,439.62
2023-08-02,Food,3.21E+11,2023-08-02,24,0,415.62
2023-08-02,Misc,3.21E+11,2023-08-02,6,0,409.62
2023-08-02,Misc,3.21E+11,2023-08-02,140,0,269.62
2023-08-02,Food,3.21E+11,2023-08-02,30,0,239.62
2023-08-03,Food,3.58E+11,2023-08-03,55,0,184.62
2023-08-03,Food,3.22E+11,2023-08-03,40,0,144.62
2023-08-03,Food,3.22E+11,2023-08-03,40,0,104.62
2023-08-03,Food,3.22E+11,2023-08-03,40,0,64.62
2023-08-04,Food,3.22E+11,2023-08-04,20,0,44.62
2023-08-05,Misc,3.58E+11,2023-08-05,0,13000,13044.62
2023-08-05,Misc,3.22E+11,2023-08-05,13000,0,44.62
2023-08-11,Misc,3.22E+11,2023-08-11,0,1000,1044.62
2023-08-11,Food,3.22E+11,2023-08-11,85,0,959.62
2023-08-11,Food,3.22E+11,2023-08-11,30,0,929.62
2023-08-11,Food,3.22E+11,2023-08-11,50,0,879.62
2023-08-11,Misc,3.22E+11,2023-08-11,179,0,700.62
2023-08-11,Food,3.59E+11,2023-08-11,10,0,690.62
2023-08-11,Food,3.59E+11,2023-08-11,60,0,630.62
2023-08-12,Misc,3.22E+11,2023-08-12,393,0,237.62
2023-08-12,Food,3.22E+11,2023-08-12,30,0,207.62
2023-08-12,Food,3.22E+11,2023-08-12,66,0,141.62
2023-08-13,Misc,3.23E+11,2023-08-13,0,2000,2141.62
2023-08-13,Food,3.23E+11,2023-08-13,80,0,2061.62
2023-08-13,Food,3.23E+11,2023-08-13,50,0,2011.62
2023-08-13,Misc,3.23E+11,2023-08-13,130,0,1881.62
2023-08-13,Misc,3.23E+11,2023-08-13,189,0,1692.62
2023-08-13,Food,3.23E+11,2023-08-13,30,0,1662.62
2023-08-13,Misc,3.23E+11,2023-08-13,500,0,1162.62
2023-08-13,Food,3.23E+11,2023-08-14,10,0,1152.62
2023-08-14,Food,3.23E+11,2023-08-14,99,0,1053.62
2023-08-14,Food,3.23E+11,2023-08-14,50,0,1003.62
2023-08-14,Food,3.23E+11,2023-08-14,50,0,953.62
2023-08-14,Misc,3.23E+11,2023-08-14,358,0,595.62
2023-08-14,Food,3.23E+11,2023-08-14,30,0,565.62
2023-08-15,Food,3.23E+11,2023-08-15,20,0,545.62
2023-08-15,Food,3.23E+11,2023-08-15,40,0,505.62
2023-08-15,Food,3.23E+11,2023-08-15,30,0,475.62
2023-08-15,Misc,3.23E+11,2023-08-15,0,25,500.62
2023-08-16,Food,3.23E+11,2023-08-16,60,0,440.62
2023-08-16,Food,3.23E+11,2023-08-16,10,0,430.62
2023-08-16,Food,3.23E+11,2023-08-16,40,0,390.62
2023-08-16,Food,3.23E+11,2023-08-16,42,0,348.62
2023-08-16,Misc,3.23E+11,2023-08-16,230,0,118.62
2023-08-16,Food,3.23E+11,2023-08-16,40,0,78.62
2023-08-17,Food,3.23E+11,2023-08-17,50,0,28.62
2023-08-17,Misc,3.23E+11,2023-08-17,0,1500,1528.62
2023-08-17,Misc,3.23E+11,2023-08-17,1000,0,528.62
2023-08-17,Food,3.23E+11,2023-08-17,50,0,478.62
2023-08-17,Food,3.6E+11,2023-08-17,161.55,0,317.07
2023-08-18,Food,3.23E+11,2023-08-18,60,0,257.07
2023-08-18,Food,3.23E+11,2023-08-18,40,0,217.07
2023-08-18,Food,3.6E+11,2023-08-18,67.2,0,149.87
2023-08-18,Food,3.23E+11,2023-08-18,20,0,129.87
2023-08-18,Misc,3.23E+11,2023-08-18,0,1000,1129.87
2023-08-18,Food,3.23E+11,2023-08-18,86,0,1043.87
2023-08-18,Misc,3.6E+11,2023-08-18,276,0,767.87
2023-08-18,Food,3.23E+11,2023-08-18,50,0,717.87
2023-08-19,Misc,3.23E+11,2023-08-19,390,0,327.87
2023-08-19,Food,3.23E+11,2023-08-19,40,0,287.87
2023-08-19,Misc,3.23E+11,2023-08-19,0,1000,1287.87
2023-08-19,Food,3.23E+11,2023-08-19,50,0,1237.87
2023-08-19,Food,3.23E+11,2023-08-19,40,0,1197.87
2023-08-20,Food,3.23E+11,2023-08-20,20,0,1177.87
2023-08-20,Food,3.23E+11,2023-08-20,30,0,1147.87
2023-08-20,Food,3.23E+11,2023-08-20,60,0,1087.87
2023-08-20,Food,3.23E+11,2023-08-20,60,0,1027.87
2023-08-20,Misc,3.23E+11,2023-08-20,5,0,1022.87
2023-08-20,Food,3.6E+11,2023-08-20,174.95,0,847.92
2023-08-20,Food,3.23E+11,2023-08-20,40,0,807.92
2023-08-20,Misc,3.23E+11,2023-08-20,400,0,407.92
2023-08-20,Food,3.23E+11,2023-08-21,20,0,387.92
2023-08-21,Misc,3.23E+11,2023-08-21,160,0,227.92
2023-08-21,Food,3.23E+11,2023-08-21,50,0,177.92
2023-08-21,Food,3.23E+11,2023-08-21,22,0,155.92
2023-08-21,Food,3.6E+11,2023-08-21,75,0,80.92
2023-08-21,Food,3.23E+11,2023-08-21,40,0,40.92
2023-08-22,Misc,3.23E+11,2023-08-22,0,1000,1040.92
2023-08-22,Food,3.6E+11,2023-08-22,70,0,970.92
2023-08-22,Misc,3.23E+11,2023-08-22,0,70,1040.92
2023-08-22,Food,3.6E+11,2023-08-22,55,0,985.92
2023-08-22,Food,3.23E+11,2023-08-22,50,0,935.92
2023-08-22,Food,3.23E+11,2023-08-22,10,0,925.92
2023-08-22,Food,3.23E+11,2023-08-22,38,0,887.92
2023-08-22,Food,3.23E+11,2023-08-22,20,0,867.92
2023-08-23,Food,3.6E+11,2023-08-23,28,0,839.92
2023-08-23,Food,3.24E+11,2023-08-23,23,0,816.92
2023-08-23,Food,3.24E+11,2023-08-23,30,0,786.92
2023-08-23,Food,3.24E+11,2023-08-23,50,0,736.92
2023-08-23,Food,3.24E+11,2023-08-23,30,0,706.92
2023-08-23,Misc,3.24E+11,2023-08-23,200,0,506.92
2023-08-24,Food,3.24E+11,2023-08-24,201,0,305.92
2023-08-24,Food,3.24E+11,2023-08-24,100,0,205.92
2023-08-24,Food,3.24E+11,2023-08-24,50,0,155.92
2023-08-24,Food,3.24E+11,2023-08-24,59,0,96.92
2023-08-24,Food,3.24E+11,2023-08-24,50,0,46.92
2023-08-25,Salary,CHASV23235906561,2023-08-25,0,34800,34846.92
2023-08-25,Misc,3.6E+11,2023-08-25,5000,0,29846.92
2023-08-25,Misc,3.6E+11,2023-08-25,8000,0,21846.92
2023-08-25,Misc,3.6E+11,2023-08-25,1000,0,20846.92
2023-08-25,Misc,3.6E+11,2023-08-25,1000,0,19846.92
2023-08-25,Food,3.24E+11,2023-08-25,34,0,19812.92
2023-08-25,Misc,3.24E+11,2023-08-25,1000,0,18812.92
2023-08-25,Misc,3.24E+11,2023-08-25,380,0,18432.92
2023-08-25,Misc,3.6E+11,2023-08-25,0,140,18572.92
2023-08-25,Food,3.24E+11,2023-08-25,100,0,18472.92
2023-08-25,Misc,3.24E+11,2023-08-25,1720,0,16752.92
2023-08-25,Misc,3.24E+11,2023-08-25,200,0,16552.92
2023-08-25,Misc,3.24E+11,2023-08-25,188,0,16364.92
2023-08-25,Food,3.24E+11,2023-08-25,40,0,16324.92
2023-08-25,Food,3.24E+11,2023-08-25,70,0,16254.92
2023-08-25,Misc,3.6E+11,2023-08-25,0,15,16269.92
2023-08-25,Food,3.24E+11,2023-08-25,50,0,16219.92
2023-08-26,Misc,3.24E+11,2023-08-26,120,0,16099.92
2023-08-26,Food,3.24E+11,2023-08-26,30,0,16069.92
2023-08-26,Misc,3.24E+11,2023-08-26,430,0,15639.92
2023-08-26,Misc,3.6E+11,2023-08-26,0,70,15709.92
2023-08-26,Misc,3.24E+11,2023-08-26,112,0,15597.92
2023-08-26,Misc,3.6E+11,2023-08-26,0,10,15607.92
2023-08-26,Misc,3.24E+11,2023-08-26,118,0,15489.92
2023-08-26,Food,3.24E+11,2023-08-26,10,0,15479.92
2023-08-26,Misc,3.24E+11,2023-08-26,1000,0,14479.92
2023-08-26,Food,3.6E+11,2023-08-26,188.2,0,14291.72
2023-08-26,Food,3.6E+11,2023-08-26,40,0,14251.72
2023-08-27,Misc,3.24E+11,2023-08-27,199,0,14052.72
2023-08-27,Food,3.24E+11,2023-08-27,30,0,14022.72
2023-08-27,Food,3.24E+11,2023-08-27,58,0,13964.72
2023-08-27,Misc,3.61E+11,2023-08-27,0,12,13976.72
2023-08-27,Food,3.24E+11,2023-08-27,100,0,13876.72
2023-08-27,Food,3.24E+11,2023-08-27,50,0,13826.72
2023-08-28,Food,3.24E+11,2023-08-28,203.66,0,13623.06
2023-08-28,Misc,3.61E+11,2023-08-28,105,0,13518.06
2023-08-28,Food,3.24E+11,2023-08-29,40,0,13478.06
2023-08-29,Misc,3.24E+11,2023-08-29,5,0,13473.06
2023-08-29,Food,3.61E+11,2023-08-29,23,0,13450.06
2023-08-29,Food,3.24E+11,2023-08-29,30,0,13420.06
2023-08-29,Food,3.24E+11,2023-08-29,43,0,13377.06
2023-08-29,Food,3.24E+11,2023-08-29,10,0,13367.06
2023-08-29,Food,3.61E+11,2023-08-29,185.2,0,13181.86
2023-08-30,Misc,3.61E+11,2023-08-30,110,0,13071.86
2023-08-30,Misc,3.24E+11,2023-08-30,0,55,13126.86
2023-08-30,Food,3.24E+11,2023-08-30,40,0,13086.86
2023-08-30,Food,3.61E+11,2023-08-30,100,0,12986.86
2023-08-30,Food,3.24E+11,2023-08-30,40,0,12946.86
2023-08-31,Food,3.24E+11,2023-08-31,30,0,12916.86
2023-08-31,Food,3.61E+11,2023-08-31,100,0,12816.86
2023-08-31,Food,3.24E+11,2023-08-31,30,0,12786.86
2023-08-31,Misc,3.24E+11,2023-08-31,0,20000,32786.86
2023-08-31,Misc,3.24E+11,2023-08-31,20000,0,12786.86
2023-08-31,Misc,3.24E+11,2023-08-31,440,0,12346.86
2023-09-01,Rent,3.24E+11,2023-09-01,7310,0,5036.86
2023-09-01,Misc,3.24E+11,2023-09-01,110,0,4926.86
2023-09-01,Food,3.24E+11,2023-09-01,20,0,4906.86
2023-09-01,Food,3.24E+11,2023-09-01,30,0,4876.86
2023-09-01,Misc,3.24E+11,2023-09-01,447,0,4429.86
2023-09-01,Food,3.24E+11,2023-09-01,52,0,4377.86
2023-09-01,Food,3.24E+11,2023-09-01,20,0,4357.86
2023-09-02,Food,3.61E+11,2023-09-02,188.2,0,4169.66
2023-09-02,Food,3.25E+11,2023-09-02,50,0,4119.66
2023-09-02,Food,3.61E+11,2023-09-02,136.76,0,3982.9
2023-09-02,Food,3.25E+11,2023-09-02,0,136.76,4119.66
2023-09-03,Food,3.25E+11,2023-09-03,30,0,4089.66
2023-09-03,Food,3.25E+11,2023-09-03,36,0,4053.66
2023-09-03,Food,3.25E+11,2023-09-03,60,0,3993.66
2023-09-03,Food,3.25E+11,2023-09-03,20,0,3973.66
2023-09-04,Food,3.25E+11,2023-09-04,30,0,3943.66
2023-09-04,Food,3.25E+11,2023-09-04,55,0,3888.66
2023-09-04,Misc,3.25E+11,2023-09-04,250,0,3638.66
2023-09-04,Food,3.25E+11,2023-09-04,30,0,3608.66
2023-09-05,Food,3.25E+11,2023-09-05,80,0,3528.66
2023-09-05,Food,3.25E+11,2023-09-05,50,0,3478.66
2023-09-05,Misc,3.61E+11,2023-09-06,1000,0,2478.66
2023-09-06,Food,3.62E+11,2023-09-06,55,0,2423.66
2023-09-06,Food,3.25E+11,2023-09-06,40,0,2383.66
2023-09-06,Food,3.62E+11,2023-09-06,217.95,0,2165.71
2023-09-06,Food,3.25E+11,2023-09-06,60,0,2105.71
2023-09-07,Misc,3.25E+11,2023-09-07,170,0,1935.71
2023-09-07,Misc,3.25E+11,2023-09-07,200,0,1735.71
2023-09-07,Food,3.25E+11,2023-09-07,40,0,1695.71
2023-09-07,Food,3.25E+11,2023-09-07,80,0,1615.71
2023-09-07,Food,3.25E+11,2023-09-07,85,0,1530.71
2023-09-08,Food,3.25E+11,2023-09-08,25,0,1505.71
2023-09-08,Food,3.25E+11,2023-09-08,40,0,1465.71
2023-09-08,Misc,3.25E+11,2023-09-08,0,80,1545.71
2023-09-08,Misc,3.62E+11,2023-09-08,190,0,1355.71
2023-09-09,Misc,3.25E+11,2023-09-09,279.5,0,1076.21
2023-09-09,Food,3.25E+11,2023-09-09,52,0,1024.21
2023-09-09,Food,3.25E+11,2023-09-09,30,0,994.21
2023-09-09,Food,3.25E+11,2023-09-09,10,0,984.21
2023-09-09,Food,3.25E+11,2023-09-09,40,0,944.21
2023-09-10,Food,3.25E+11,2023-09-10,230.7,0,713.51
2023-09-10,Food,3.25E+11,2023-09-10,54,0,659.51
2023-09-10,Misc,3.62E+11,2023-09-10,0,500,1159.51
2023-09-10,Food,3.62E+11,2023-09-10,426.94,0,732.57
2023-09-11,Food,3.25E+11,2023-09-11,192.24,0,540.33
2023-09-11,Food,3.25E+11,2023-09-11,55,0,485.33
2023-09-11,Food,3.25E+11,2023-09-11,80,0,405.33
2023-09-11,Food,3.25E+11,2023-09-11,20,0,385.33
2023-09-11,Food,3.25E+11,2023-09-11,10,0,375.33
2023-09-11,Food,3.25E+11,2023-09-11,10,0,365.33
2023-09-11,Misc,3.25E+11,2023-09-11,125,0,240.33
2023-09-12,Food,3.26E+11,2023-09-12,30,0,210.33
2023-09-12,Food,3.26E+11,2023-09-12,55,0,155.33
2023-09-12,Food,3.26E+11,2023-09-12,40,0,115.33
2023-09-12,Food,3.26E+11,2023-09-12,60,0,55.33
2023-09-12,Food,3.26E+11,2023-09-12,10,0,45.33
2023-09-13,Food,3.62E+11,2023-09-13,23,0,22.33
2023-09-16,Food,3.26E+11,2023-09-16,10,0,12.33
2023-09-23,Misc,3.27E+11,2023-09-23,0,1000,1012.33
2023-09-23,Misc,3.27E+11,2023-09-23,300.1,0,712.23
2023-09-23,Misc,3.27E+11,2023-09-23,700,0,12.23
2023-09-25,Salary,CHASH26441571950,2023-09-25,0,34800,34812.23
2023-09-25,Misc,3.27E+11,2023-09-25,7451,0,27361.23
2023-09-25,Misc,3.63E+11,2023-09-25,0,7152,34513.23
2023-09-25,Misc,3.27E+11,2023-09-25,8624,0,25889.23
2023-09-25,Misc,3.63E+11,2023-09-25,10000,0,15889.23
2023-09-25,Misc,3.63E+11,2023-09-25,2313,0,13576.23
2023-09-25,Misc,3.63E+11,2023-09-25,7500,0,6076.23
2023-09-25,Misc,3.27E+11,2023-09-25,120,0,5956.23
2023-09-25,Food,3.27E+11,2023-09-25,36,0,5920.23
2023-09-25,Food,3.27E+11,2023-09-25,40,0,5880.23
2023-09-25,Misc,3.63E+11,2023-09-25,275,0,5605.23
2023-09-25,Misc,3.27E+11,2023-09-25,329,0,5276.23
2023-09-26,Food,3.27E+11,2023-09-26,36,0,5240.23
2023-09-26,Food,3.27E+11,2023-09-26,10,0,5230.23
2023-09-26,Food,3.27E+11,2023-09-26,50,0,5180.23
2023-09-26,Food,3.64E+11,2023-09-26,159.56,0,5020.67
2023-09-26,Misc,3.27E+11,2023-09-26,1000,0,4020.67
2023-09-27,Food,3.64E+11,2023-09-27,55,0,3965.67
2023-09-27,Food,3.27E+11,2023-09-27,50,0,3915.67
2023-09-28,Food,3.64E+11,2023-09-28,100,0,3815.67
2023-09-28,Food,3.27E+11,2023-09-28,40,0,3775.67
2023-09-28,Food,3.64E+11,2023-09-28,155.5,0,3620.17
2023-09-28,Misc,3.27E+11,2023-09-28,240,0,3380.17
2023-09-28,Misc,3.27E+11,2023-09-28,247,0,3133.17
2023-09-29,Food,3.27E+11,2023-09-29,48,0,3085.17
2023-09-29,Food,3.27E+11,2023-09-29,20,0,3065.17
2023-09-29,Misc,3.27E+11,2023-09-29,880,0,2185.17
2023-09-30,Misc,3.27E+11,2023-09-30,110,0,2075.17
2023-09-30,Food,3.27E+11,2023-09-30,10,0,2065.17
2023-09-30,Misc,3.27E+11,2023-09-30,183.85,0,1881.32
2023-09-30,Food,3.27E+11,2023-09-30,50,0,1831.32
2023-10-01,Misc,0,2023-09-30,0,20,1851.32
2023-10-01,Food,3.27E+11,2023-10-01,20,0,1831.32
2023-10-01,Food,3.27E+11,2023-10-01,20,0,1811.32
2023-10-01,Food,3.27E+11,2023-10-01,25,0,1786.32
2023-10-01,Food,3.27E+11,2023-10-01,50,0,1736.32
2023-10-01,Food,3.27E+11,2023-10-01,85,0,1651.32
2023-10-02,Food,3.27E+11,2023-10-02,10,0,1641.32
2023-10-02,Food,3.28E+11,2023-10-02,49,0,1592.32
2023-10-02,Food,3.64E+11,2023-10-02,30,0,1562.32
2023-10-02,Food,3.28E+11,2023-10-02,49,0,1513.32
2023-10-02,Food,3.28E+11,2023-10-02,80,0,1433.32
2023-10-02,Food,3.28E+11,2023-10-02,30,0,1403.32
2023-10-02,Misc,3.28E+11,2023-10-02,470,0,933.32
2023-10-03,Food,3.28E+11,2023-10-03,19,0,914.32
2023-10-03,Misc,3.28E+11,2023-10-03,130,0,784.32
2023-10-03,Food,3.64E+11,2023-10-03,188.74,0,595.58
2023-10-03,Food,3.28E+11,2023-10-03,48,0,547.58
2023-10-03,Food,3.28E+11,2023-10-03,10,0,537.58
2023-10-03,Misc,3.28E+11,2023-10-03,0,385,922.58
2023-10-03,Misc,3.28E+11,2023-10-03,680,0,242.58
2023-10-03,Misc,3.28E+11,2023-10-03,0,43,285.58
2023-10-03,Misc,3.64E+11,2023-10-03,0,1000,1285.58
2023-10-03,Misc,3.28E+11,2023-10-03,370,0,915.58
2023-10-04,Food,3.64E+11,2023-10-04,80,0,835.58
2023-10-04,Food,3.64E+11,2023-10-04,45,0,790.58
2023-10-04,Misc,3.28E+11,2023-10-04,120,0,670.58
2023-10-04,Food,3.28E+11,2023-10-04,12,0,658.58
2023-10-05,Food,3.28E+11,2023-10-05,35,0,623.58
2023-10-05,Food,3.64E+11,2023-10-05,70,0,553.58
2023-10-05,Food,3.64E+11,2023-10-05,75,0,478.58
2023-10-06,Food,3.28E+11,2023-10-06,33,0,445.58
2023-10-06,Food,3.28E+11,2023-10-06,95,0,350.58
2023-10-07,Food,3.28E+11,2023-10-07,87.69,0,262.89
2023-10-07,Misc,3.65E+11,2023-10-07,184,0,78.89
2023-10-09,Misc,3.28E+11,2023-10-09,0,1000,1078.89
2023-10-09,Food,3.28E+11,2023-10-09,79,0,999.89
2023-10-10,Food,3.28E+11,2023-10-10,50,0,949.89
2023-10-10,Food,3.65E+11,2023-10-10,42,0,907.89
2023-10-11,Food,3.65E+11,2023-10-11,80,0,827.89
2023-10-12,Food,3.65E+11,2023-10-12,70,0,757.89
2023-10-13,Food,3.29E+11,2023-10-13,36,0,721.89
2023-10-13,Misc,3.65E+11,2023-10-13,270,0,451.89
2023-10-14,Food,3.29E+11,2023-10-14,24,0,427.89
2023-10-14,Misc,3.29E+11,2023-10-14,0,270,697.89
2023-10-16,Misc,3.29E+11,2023-10-16,291,0,406.89
2023-10-16,Misc,3.66E+11,2023-10-16,0,3500,3906.89
2023-10-16,Misc,3.29E+11,2023-10-16,1500,0,2406.89
2023-10-16,Misc,3.29E+11,2023-10-16,0,286,2692.89
2023-10-16,Misc,3.29E+11,2023-10-16,300,0,2392.89
2023-10-16,Misc,3.29E+11,2023-10-16,150,0,2242.89
2023-10-16,Food,3.29E+11,2023-10-16,40,0,2202.89
2023-10-16,Misc,3.66E+11,2023-10-16,248,0,1954.89
2023-10-16,Food,3.66E+11,2023-10-16,30,0,1924.89
2023-10-16,Food,3.66E+11,2023-10-16,214.74,0,1710.15
2023-10-17,Food,3.29E+11,2023-10-17,65,0,1645.15
2023-10-17,Misc,3.29E+11,2023-10-17,706,0,939.15
2023-10-17,Misc,3.29E+11,2023-10-17,150,0,789.15
2023-10-17,Misc,3.29E+11,2023-10-17,234,0,555.15
2023-10-17,Food,3.29E+11,2023-10-17,60,0,495.15
2023-10-18,Food,3.29E+11,2023-10-18,65,0,430.15
2023-10-18,Food,3.29E+11,2023-10-18,10,0,420.15
2023-10-19,Food,3.29E+11,2023-10-19,20,0,400.15
2023-10-20,Food,3.29E+11,2023-10-20,18,0,382.15
2023-10-20,Food,3.29E+11,2023-10-20,25,0,357.15
2023-10-26,Food,3.3E+11,2023-10-26,100,0,257.15
2023-10-26,Misc,3.3E+11,2023-10-26,0,3150,3407.15
2023-10-27,Misc,3.67E+11,2023-10-27,3407,0,0.15
2023-11-01,Misc,3.31E+11,2023-11-01,0,500,500.15
2023-11-01,Misc,3.31E+11,2023-11-01,500,0,0.15
2023-11-02,Misc,3.31E+11,2023-11-02,0,1000,1000.15
2023-11-02,Misc,3.67E+11,2023-11-02,1000,0,0.15
2023-11-02,Misc,3.31E+11,2023-11-02,0,1000,1000.15
2023-11-02,Misc,3.67E+11,2023-11-02,1000,0,0.15
2023-11-15,Misc,CHASH31948851670,2023-11-15,0,33209,33209.15
2023-11-15,Misc,3.69E+11,2023-11-15,5000,0,28209.15
2023-11-15,Misc,3.69E+11,2023-11-15,3500,0,24709.15
2023-11-15,Misc,3.69E+11,2023-11-15,20000,0,4709.15
2023-11-15,Misc,3.69E+11,2023-11-15,1500,0,3209.15
2023-11-17,Food,3.32E+11,2023-11-17,69,0,3140.15
2023-11-18,Food,3.32E+11,2023-11-18,100,0,3040.15
2023-11-18,Misc,3.32E+11,2023-11-18,116,0,2924.15
2023-11-20,Shopping,3.69E+11,2023-11-20,1999,0,925.15
2023-11-20,Shopping,3.69E+11,2023-11-20,0,1999,2924.15
2023-11-22,Misc,3.33E+11,2023-11-22,150,0,2774.15
2023-11-22,Misc,3.33E+11,2023-11-22,150,0,2624.15
2023-11-24,Salary,CHASH32649207986,2023-11-24,0,24769,27393.15
2023-11-24,Shopping,3.69E+11,2023-11-24,499,0,26894.15
2023-11-24,Misc,3.33E+11,2023-11-24,1499,0,25395.15
2023-11-24,Misc,3.69E+11,2023-11-24,2000,0,23395.15
2023-11-25,Misc,3.7E+11,2023-11-25,21000,0,2395.15
2023-11-26,Food,3.33E+11,2023-11-26,223.18,0,2171.97
2023-11-27,Misc,3.33E+11,2023-11-27,0,272,2443.97
2023-11-27,Misc,3.7E+11,2023-11-27,720,0,1723.97
2023-11-28,Misc,3.7E+11,2023-11-28,480,0,1243.97
2023-11-28,Misc,3.7E+11,2023-11-28,250,0,993.97
2023-11-30,Misc,3.7E+11,2023-11-30,130,0,863.97
2023-11-30,Misc,3.33E+11,2023-11-30,0,50,913.97
2023-12-01,Food,3.7E+11,2023-12-02,19,0,894.97
2023-12-02,Misc,3.34E+11,2023-12-02,200,0,694.97
2023-12-03,Misc,3.34E+11,2023-12-03,120,0,574.97
2023-12-03,Misc,3.34E+11,2023-12-03,0,7,581.97
2023-12-03,Misc,3.34E+11,2023-12-03,0,70,651.97
2023-12-04,Misc,3.34E+11,2023-12-04,500,0,151.97
2023-12-04,Misc,3.34E+11,2023-12-04,0,500,651.97
2023-12-04,Misc,3.34E+11,2023-12-04,450,0,201.97
2023-12-06,Misc,3.71E+11,2023-12-06,0,150,351.97
2023-12-06,Food,3.71E+11,2023-12-06,60,0,291.97
2023-12-07,Misc,3.34E+11,2023-12-08,0,15000,15291.97
2023-12-09,Misc,3.34E+11,2023-12-09,15048,0,243.97
2023-12-10,Misc,3.71E+11,2023-12-10,0,4000,4243.97
2023-12-10,Transport,3.34E+11,2023-12-10,3062,0,1181.97
2023-12-10,Misc,3.71E+11,2023-12-10,1000,0,181.97
2023-12-10,Misc,3.34E+11,2023-12-10,0,1000,1181.97
2023-12-11,Food,3.71E+11,2023-12-11,30,0,1151.97
2023-12-11,Food,3.71E+11,2023-12-11,10,0,1141.97
2023-12-11,Food,3.71E+11,2023-12-11,30,0,1111.97
2023-12-11,Misc,3.71E+11,2023-12-11,220,0,891.97
2023-12-11,Food,3.35E+11,2023-12-11,169.29,0,722.68
2023-12-12,Food,3.71E+11,2023-12-12,25,0,697.68
2023-12-12,Food,3.71E+11,2023-12-12,40,0,657.68
2023-12-12,Food,3.71E+11,2023-12-12,20,0,637.68
2023-12-12,Misc,3.35E+11,2023-12-12,530,0,107.68
2023-12-12,Food,3.71E+11,2023-12-12,35,0,72.68
2023-12-12,Misc,3.35E+11,2023-12-12,0,1718,1790.68
2023-12-12,Transport,3.35E+11,2023-12-12,1718,0,72.68
2023-12-13,Food,3.71E+11,2023-12-13,26,0,46.68
2023-12-13,Food,3.71E+11,2023-12-13,15,0,31.68
2023-12-13,Transport,3.35E+11,2023-12-13,0,1718,1749.68
2023-12-13,Misc,3.71E+11,2023-12-13,1718,0,31.68
2024-01-01,Misc,0,2023-12-31,0,8,39.68
